question1	question2	is_duplicate
여자친구가 데이트 시간을 너무 안 지켜.	여자친구가 데이트 시간을 너무 안 지켜.	0
집앞에서 첫사랑 만남	집앞에서 첫사랑 만남	0
어이가 없네	어이상실	0
전화 안 받으니까 초조해져	전화 안 받는 이유가 뭘까	0
연인인데 정치견해가 달라	연인인데 정치적인 견해가 달라	0
이 좀 여유롭게 살고 싶다	여유롭게 살고 싶어	0
냄새날 것 같아 걱정이야	냄새나면 어쩌지	0
혼자 있는 시간이 정말 힘드네	혼자가 되고	1
자연이 넘 예뻐	폭우가 쏟아져서 비 맛았어	1
선풍기 틀어도 더워	선풍기만으로 안 되는 더위	0
어장인건가	어장인건가	0
남자친구가 좋은데 신뢰가 안 생겨.	남자친구가 좋은데 믿지 못하겠어.	0
어느새 헤어진지 한달	어떤 날도, 어떤 말도	1
아부쟁이가 부러워	아부 잘 하는 사람 부럽기도 해	0
짝사랑은 짝사랑으로 남는게 좋은 걸까요.	짝사랑은 짝사랑으로 남는게 좋은 걸까요.	0
새벽에 카톡이 왔네.	생각을 고쳐 먹었습니다	1
다시 썸 타는 방법	덜 좋아하는게 답인 것 같아.	1
제정신이 아닌거 같아	조금씩 아물어가는건가 이별의 상처	1
짝사랑은 힘든 거 같아	짝사랑은 힘든 거 같아	0
너무 좋아하면 남자친구가 부담스러워 할까?	좋아하는거 티내면 남자친구가 부담스러워 할까?	0
가까운 곳으로 나들이 갈까	바람 쐬러 어디 근교로 나갈까	0
재회후 또 이별	저는 이별하면 남자만 힘든 줄 알았어요.	1
미세먼지 지수 뭐야?	미세먼지 나쁨인가	0
강아지 키우고 싶은데 역시 안돼겠지	강아지 키울 수 있을까	0
기숙사 사는거 어떨까?	기숙사 살면 불편해?	0
효율적으로 시간 보내는 방법	하루를 효율적으로 보내고 싶어	0
드디어 전세방 구했어	오늘 전세 계약했어. 	0
노후 걱정 벌써 해야하나?	노후 걱정 벌써 해야하나?	0
이제 한달 됐네	오늘로 한달됐어	0
다 허무하다	다 필요없어	0
그녀를 떠나보내야 하나?	그녀에게 받았던 선물들을 모조리 다 버리려 합니다.	1
여친집에 찾아가고 싶은데 어떠하죠?	연락 안되서 헤어졌는데 또 연락 기다리고 있네	1
집에 먼지가 너무 많아	청소를 안 했더니 먼지 쌓였어	0
여자친구와 첫키스는 언제했어?	여자친구와 첫키스는 언제했어?	0
누가 날 좋아하는 걸 알면 어떤 생각이 들어?	누가 날 좋아하는 걸 알면 어떤 생각이 들어?	0
남자는 좋아하는 여자랑 눈 마주치면 어떻게 해?	남자들은 좋아하는 여자가 자기보다 능력이 좋은 경우에 아무리 좋아해도 마음 접고 포기하나요?	1
좀 만 덜 게을렀으면	초조한데 잘 안되네	1
전남친 집앞	전남친한테 한달만에 연락하고싶어 ㅠㅠ	1
무기력한 것일뿐	무기력해	0
정열적인 사랑 하고 싶어	정열적인 사랑을 하고 싶어	0
편의점 알바 면접 간다	카페 알바 면접 간다	1
보험 많이 들었어	보험 많이 든 거 같애	0
짱 추워	오늘 왤케 추워	0
이제 봄인가봐	봄인가봐	0
휴대폰 중독인 것같아	핸드폰 중독인듯	0
게임 때문에 폰이 점점 느려지는듯	폰게임 때매 폰 느려지는듯	0
오늘 헤어짐을 말하려 합니다	오늘도 술 몇 잔 마시니 생각나네요.	1
이제는 놓아줄꺼라 생각하지만	이제는 정말 끝	1
좋아하는 애랑 만나서 놀건데 뭐 먹는게 좋을까?	좋아하는 애랑 만나서 놀건데 뭐 먹는게 좋을까?	0
이건 이별을 준비해야 하는건가??	이게 잠수이별인가???	1
커피 볶는 시간	커피콩 볶고 있어	0
헤어진지 두달 무덤덤한데	헤어진지 삼일째입니다	1
워터파크에서 마지막 즐기러 갈 준비	여름에는 워터파크 한 번 가줘야 할 것 같아	0
마음이 아픈 것도 몸 아픈 거랑 똑같구나	맘 아프고 힘들어	0
카톡을 탈퇴했나봐.	코 앞이 재회.	1
꽃다발 샀어	꽃다발 준비했어	0
아직 내감정 잘 모르겠는데 유지하는 게 좋을까	내 감정도 헷갈리는데 어떻게 하는게 좋을까	0
좋아하는 여자 생겼으면 좋겠다.	좋아하는 애한테 하고 싶은 말이 뭐야?	1
행복한 인생 돌싱남	행여 잃을까봐 꼭 쥐고 있어야 하는건 내 것이 아닙니다.	1
결국 이렇게 헤어졌어	결국엔 바람난거였네	1
사랑이 싹 트고 있어	조금씩 마음 속에 사랑이 싹 트고 있어	0
갑자기 훅 힘들어져	많이 힘드네	0
그냥 선 볼까?	선 볼까?	0
뭐부터 바꿔야 할까	뭘 바꿔야 할까	0
넘어져서 발목 삔 거 같애	발목 삔 거 같애	0
새로운 시작을 하는 전여친. 너무 힘들어.	4년 만난 여자와 이별한지 5개월 다되어가네.	1
영화같은 사랑 하고 싶어	영화같은 사랑 하고 싶어	0
부치지 못한 편지	붙잡고 싶습니다.	1
다시 찾아온 이별	다시 헤어진 직후로 돌아간거같아	1
마음을 보여 주고 싶어.	마음이 보였으면 좋겠어	0
사전뜻이 이상해	사전이 이상해	0
엄마한테 혼났어	엄마랑 싸웠어	0
마음에 안 차는데 만나도 돼?	완전 좋은 건 아닌데 만나도 돼?	0
나도 이제 아재인가	재미 없어.	1
썸남 생겼는데 프사 뭐할까?	썸남 생겼는데 프로필 사진 뭐할까?	0
만난지 200일됐어	우리 드디어 만난지 200일 됐어	0
나 쉬운 사람이라고 생각하면 어쩌지?	나 쉬운 여자 아니야	0
이별 중독	이별 한달 반째	1
내가 좋아할 자격이 있나 모르겠어.	내가 좋아할 자격이 있나.	0
책 보는데 글자만 들어와	책보는데 글자만 봤어	0
운동하면 뭐 하나	운동해도 살이 안 빠져	0
행복하게 살텐데 왜 나는 못잊겠지	거짓말은 진짜 못고치는 병 맞죠?	1
사랑 고민	사랑 고민 말해도 되나요?	0
한달이 넘었네	한달 지났네	0
회 먹으러 가야겠다.	회 먹어야지	0
썸 탈 때 예민한 부분 말해?	썸 탈 때 민감한 문제 말해?	0
슬퍼.	슬픔이 더 커지는 아침이네	0
중국어 혼자 공부 가능한가?	지금 생각하고 있는건 망상 일뿐입니다	1
우린 운명이었어	우린 운명이었어	0
층간소음에 살인 난다더니.	층간소음 때문에 왜 살인이 나는지 알 거 같애	0
걔는 누굴 닮아서 그런거니?	누굴 닮아서 그런건지	0
모르는 걸까? 모르는 철 하는 걸까?	아는데 모른척하나?	0
제가나쁜건지 그녀가나쁜건지.	제잘못으로인한이별	1
짝녀한테 실망했음.	짝녀한테 실망했음.	0
이제 끝인 줄 알았는데 계속 좋아하고 있었어.	이제 청첩장 돌려도 되겠지?	1
술 끊을거야	술 좀 그만 마셔야지	0
돈 벌고 싶어	나도 월급 필요해	0
짝남이 나를 떠보는 걸까?	짝남이 나를 떠보는 걸까?	0
맘 잡았다고 생각했는데	맘터놓고 얘기할곳이 없네.	1
짝녀랑 드디어 사귄다!	짝녀랑 드디어 사귄다!	0
머리따로 마음따로 몸따로	머리는 아는데 가슴은 모르네	0
썸 확인법	썸 확인법	0
면접 때 너무 떨려	면접만 보면 떨려서 말을 못하겠어	0
무언가에 집중하는 남자가 좋아	집중 잘하는 남자가 좋아	0
눕자마자 잘 거 같아	누우면 바로 자	0
짝사랑 하던 사람한테 고백했는데 차임. 계속 좋아해도 될까.	짝사랑 하던 사람한테 고백했는데 차임. 계속 좋아해도 될까.	0
상사가 너무 괴롭혀	상사 때문에 힘들다	0
짝녀를 반 애들 다 알게 공개적으로 좋아하면 싫어할까요?	짝녀를 반 애들 다 알게 공개적으로 좋아하면 싫어할까요?	0
아름다운 이별은 없는걸까 ㅠ	아무도 안 놀아줘	1
만나는게 싫지는 않아	만날 땐 좋고 안 만나도 괜찮은 거 같아	0
짝남한테 크리스마스 선물할건데 추천 좀.	짝남한테 크리스마스 선물할건데 추천 좀.	0
썸남한테 소개팅 나가라고 해볼까?	썸남한테 소개팅 나가라고 해볼까?	0
짝남한테 실망했어요.	짝남한테 실망했어요.	0
여자친구의 감정기복이 너무 심해.	여자친구의 감정기복이 너무 심해.	0
편두통 온다	머리 한 대 맞은 거 같아	0
부모님께 보여드리고 싶은 사람 있어	부모님께 보여드리고 싶어	0
혼자 여행 가도 괜찮을까?	혼자 여행 괜찮을까?	0
밤새 그리워서 편지 썼어	그립다고 밤새 편지 썼어	0
사랑하는 사람이 떠난대	내가 사랑하는 사람이 떠난대	0
여자친구가 결혼을 원해	여친이 결혼하재	0
집안일이 너무 많아	집안일 쌓여 있다	0
해봤자 쓸 데 없을 텐데	쓸데없는 일 하는중	0
답프로포즈 해볼까?	데이트비용이 너무 많이 나와	1
그녀에 sns를 봤습니다.	그녀와 이별을 할때마다 한나씩 잃었었네.	1
어떻게 용기를 내	용기를 내야 되는데	0
좋아하는 사람이 있는데 고백하는 건 싫어요.	좋아하는 사람이 있는데 고백 못하겠어요.	0
난 나대로 걍 산다	난 왜이리 바보 같을까.	1
4년을 엊그제 마무리 했습니다	5년 10개월간 연애. 그리고 이별 준비 중	1
나 무시하는 사람 짜증나	나 무시하는 사람 어떻게 해?	0
정말 끝까지 저의 마지막 자존심마저 뭉개버리네	정말 너무너무 힘듭니다	1
좋아하는 남자애랑 약속 잡았는데 계속 연락 없어.	좋아하는 누나가 날 너무 어린애 취급함.	1
친구인데도 너무 잘되니까 약 오르네	친구가 잘되니까 약 올라	0
너의 향기를 지우려.	넌 그냥 외로움을 달래기 위한 거였겠지.	1
재테크 하는 방법 알려줘	재테크 어떻게 해	0
여자들은 좋아하는 사람한테만 잘해줘?	여자들은 좋아하는 사람한테만 잘해줘?	0
건강한 다이어트법	건강하게 다이어트 하는 방법	0
남자친구가 게임을 너무하는게 고민이야.	남친 맨날 게임만해	0
늦어지고 있는데 변명이 생각 안나	오늘 지각인듯 뭐라 그러지	0
차로 데려다 줬어	차로 데려다 줬는데	0
결혼하는데 돈이 엄청 드네	결혼하는데 보통 얼마 들어?	0
귀가 가려워	귀가 간지러	0
집들이 선물 뭐가 좋아	집들이 선물 뭐 사갈까	0
내가 왜 주제 넘은 짓을 했을까 가만히 있을걸	내가 주제 넘게 말한 것 같네.	0
이제 보내 주려 합니다	7년반 연애 끝났습니다.	1
점점 호감 간다	처음에는 별로 였는데 호감 간다	0
주름살이 조금씩 생긴다.	나 주름살 있나?	0
엄마 말씀 잘 들을걸	엄마 말씀 안 들은거 후회돼	0
읽씹은 아프네	잊고싶어도 잊질못하네	1
좋아하는 남자애에게 어떤 생일선물을 주면 좋아할까요?	좋아하는 마음 그만두기 힘든데 짝남이 헷갈리게 해.	1
아프지 않은 이별은 없지만, 헤어지는게 답인 관계는 있더군.	아픔을 지니고 사랑한다는 것	1
진짜 사랑해서 아픈 느낌.	진짜 이해가 안가 근데 잊을려고	1
육아 휴직 해야 하나	혼자 해야 돼	1
부모님이 이혼할 거 같아	엄마 아빠 이혼하실 거 같아	0
전화를 왜 안 받냐 진짜	전화 왜 안 받지	0
잘 먹는 여자가 좋아	잘 먹는 게 좋지	1
잘 지내고 있네여.아무일 없다는듯이.	잘못인줄 모르는 여자	1
후폭풍이 오네.	후회없이 사랑했어	1
어제 밤 샜어	밤 샜어	0
썸남이랑 궁합	썸남이랑 궁합	0
힘든 것좀 끝났으면	힘든 시기가 지나갔으면	0
내가 예민한걸까?	내가 제일 무서운건.너를 못잊을것 같은거야.	1
종교가 다른 짝남과 연애할수 있을까?	종교가 다른 짝남과 연애할수 있을까?	0
썸타는 애랑 잘되는 팁 좀	썸타는 애랑 잘되는 팁 좀	0
주말에 알바 해야 할까	주말에 이틀동안 아르바이트 구해야 하나	0
놀면서 돈 벌고 싶어	일 안하고 돈 벌고 싶어	0
내 사랑에게	내 안에서 없애고 싶다	1
2년째 동거중인데 결혼하려고	2년째 좋아하는 사람이 있어.	1
제가 그동안 착각 속에 살았습니다	제가 집착하는 중이에요	1
오늘따라 너무 힘드네	오늘만큼은 푹자고 싶은데.	1
시간표 잘못짰다	시간표 망함	0
썸 타는 사이가 이렇게 편해도 되나?	썸 타는 사이인데 너무 간섭해.	1
현실적인 문제에 헤어짐이 다가오고 있어. 결국 이별일텐데	혼자 놀로다니기만 하는 남자	1
일 대충했대	대충했다고 혼났어	0
나혼자 설레는게 한심해.	날 좋아하던 여자애가 반응이 없어.	1
몇 달을 좋아했는데 달라진게 없어요.	몇 달을 만나도 달라진게 없어요.	0
이별 6일째	이별 너무 힘드네ㅠ	1
웨딩드레스 입어보고 싶었어	웨딩드레스 입어보고 싶었어	0
뜨끈한 온천가고 싶다.	겨울에는 온천이지!	0
여자들이 보통 좋아하는 음식이 뭐야?	여자들이 좋아하는 음식이 뭐야?	0
업무 스트레스 넘 심해	넘 많이 먹었다.	1
새 프사 사진에 너는 행복해 보이네	카톡차단 당했어	1
에너지 넘치는 사람	나도 힘내야지	1
꿈꾸니까 진짜 힘드네ㅜ	꿈에 나온 헤어진 여자친구	0
세상일 참 맘대로 안된다.	소개팅에서 좋은 사람 만나기 힘든거네.	1
헤어지고나면 다른게.	헤어지기전 하소연.	1
연하 어때?	연하랑 사귀는 거 어때?	0
2달반이라는 시간동안 많이 괜찮아졌어	2주동안 참을만 했는데	1
자기 기준에 맞추라는 사람	자기 기준에 맞추라는 사람	0
우산 없는데 같이 쓰자고 할까 너무 진부한가	우산 같이 쓰자고 해볼까?	0
인형 선물 받았어	인형 선물 받았어	0
사랑한다고 말해줘	나 사랑하니?	0
점심 메뉴 추천	오늘 점심 뭐 먹을까	0
막말해서 상처줬어	생각없이 상처줬어	0
보고싶다	보고 싶어 사무칠때	0
짝녀한테 여러 번 차였는데 사귈 수 있을까요.	짝녀랑 사귈 수 있을까요.	0
잊고있다 생각했는데	잊어보려고	1
진정 사랑에 대해 배워가는중입니다	진정 사랑에 대해 배워가는중입니다	0
이렇게 치열한 경쟁은 싫어	경쟁이 너무 치열해	0
여자친구 요구가 심해져	여자친구 요구가 심해져	0
남자친구 오늘 따라 훈훈해 보인다	남자친구가 너무 잘생겼어	0
연락 자주 하는데 친군가	연락하고 싶어지네.	1
어이없는연애? 끝난걸까, 진행중일까.	어제 새벽에 그녀에게 전화가왔습니다	1
낙엽 밟는 소리 좋다	낙엽밟는 소리	0
혼자 노래방 가면 어색할 거 같은데	노래방 가면 어색할까	0
게스트하우스에서 만난 짝남이 관심이 가는데 내게 말 걸게 하고 싶어.	결혼 생각 없는데 꼭 남자친구 부모님을 만나야할까?	1
두달 사겼어	이제 두달 사귀었어	0
만난지 100일 됐는데 여행가재	100일 기념 여행가재	0
심심한데 뭐하지	심심한데 뭐하면 좋을까	0
짝사랑 했던 그에게 여자친구가 생겼어.	짝사랑 했던 그가 떠나갔어.	1
식상한 말이라도 사랑한다고 했으면 좋겠다	사랑한다고 했으면 좋겠다	0
결혼도 다 돈이다.	결혼준비 돈 많이 들겠지	0
억울한 현실	언제쯤 괜찮아지려나	1
너무 답답한데.	너무 매달렸나봐	1
청첩장 누구누구한테 주지?	청첩장 다 직접 챙겨 줘야 하나?	1
인생 잘 못 산건가	인생 헛산듯	0
내 문제는 뭘까	내 문제점이 뭘까	0
숙제가 쌓여가	숙제 산더미	0
맘 편한 데가 없어	마음 둘 곳이 없어	0
사랑은 나이를 초월해?	나이 먹으니까 왠만한건 초월하게 돼	1
미운 짓만 해	마음에 안 드는 짓만 해	0
좋아하는 사람이 나한테 먼저 연락오게 하는 방법?	좋아하는 사람한테 먼저 연락 오게 하는 방법?	0
짝사랑 하는 여자 때문에 신경이 곤두서.	짝사랑 하는 여자 때문에 신경이 곤두서.	0
체육대회 싫어	체육대회 안 했으면	0
남자친구의 말 뜻	낭만이라고는 없어가지구	1
머리가 너무 아프네	머리 아파	0
목소리 듣고싶어	몸이 멀어지면 마음도 멀어진다는말 어떻게 생각해?	1
재밌게 해줘	나 웃겨봐	0
좋아하는 여자 생겼는데 호감 표시하려면 어떻게 해야 해?	좋아하는 애한테 페메 해볼까.	1
이별. 버텨라	이별1년 8개월차	1
이별후 그리움이 생생한 오늘	이별후 열흘 뒤에 붙잡았어	1
서로 좋아하는 줄 알았는데 짝사랑이었네요.	사랑인 줄 알았는데 나만 좋아한 거였네요.	0
기분이 너무 좋아.	개좋아	0
소개해 준다는 사람도 없어	소개팅이 왜 안 들어올까	0
딴 일 찾아볼까	나 다른 거 할까	0
건강검진 왔어	건강검진하러 옴	0
여자친구가 나를 안 질려하려면 뭘 준비해야할까?	여자친구가 나를 안 질려하려면 뭘 준비해야할까?	0
계속 생각나는 사람.	고민이 되네	1
전부 가시밭길 같아	내 인생은 가시밭길 같아	0
과함 설렘 후에 지금은 안 설레	과함 설렘 후에 지금은 안 설레	0
고백은 어떻게 하는거야	고백 하는 방법 좀 알려줘	0
충전기 안 가져왔다	보조베터리 안 가져왔다	0
여친이 너무 예민해	더워서 예민해져 잠을 못 자 	1
sns에서 다른 이성이랑 대화하는걸 보니 화가 나	가슴에 구멍이 너무 커.	1
집착같은데 걔는 뭐라고 생각할까	집착인가	0
갑자기 힘드네	같이 마지막으로 다녀온 여행 생각나	1
일만 하다 죽을 것 같아	회사 일이 너무 많아	0
이상하게 놓치고 싶지 않는 사람이 있어	이상하게 놓치고 싶지 않는 사람이 있어	0
개강옷 예쁘게 입어 볼까	개강룩 입어볼까	0
수백번 싸우고 수백번 화해	술기운에 연락했는데.	1
다시 이별	다시 한번 더 붙잡고 싶어 ㅠㅠ	1
힘들어 죽을거 같습니다	힘이 없어	0
나쁜 습관이 안 고쳐져	잘 못 들인 나쁜 습관 못 고치겠어	0
나 같이 서로 좋아하는 거 확인하고 사귄 사람 있나.	나 사랑에 빠졌죠	1
이 바보탱이	이 멍충아	0
부모님 반대가 너무 심해	부모님 너무 심하게 반대 하셔	0
남자들에게 말 못하는 여자들의 이별 세가지.	남자의심리 모르겠어	1
오늘 꿈에는 짝남이 나왔으면.	오늘 꿈에는 짝남이 나왔으면.	0
친구랑 말다툼했어	친구랑 싸웠어	0
천사같은 여자친구가 유학갔어 	썸타다 끝났어	1
머리스타일 어떻게 바꾸지	머리 어떻게 할까?	0
고백하고 싶어	고백 하려는데 기회를 못잡겠어	0
여자친구랑 뭐하고 노나	여자친구랑 뭐하고 노나	0
우을증있는 여자친구	울적한 아침이에	1
결혼한지 1년 됐는데 넘 좋아	결혼한지 3개월 행복해	1
딩크족으로 살거야	걍 딩크족으로 살거야	0
썸 탈 때 꽃 선물 부담스러워 할까	썸 탈 때 꽃 선물 부담스러워 할까	0
개당황했잖아  갑자기 물어 봐서	갑자기 물어봐서 당황했어	0
썸녀 웃기는 방법 좀	웃기는 방법 좀	0
좀 있으면 귀국하는데 짝녀에게 뭘 챙겨줄까?	좀 있으면 귀국하는데 짝녀에게 뭘 챙겨줄까?	0
물배달 시켜야겠다.	물 주문해야지	0
음식 편식하는 사람 사겨도 돼?	음식 많이 가리는 남자를 사겨도 괜찮을까?	0
차였는데 좋아하는 감정이 사라지질 않아요.	차였는데 좋아하는 감정이 사라지질 않아요.	0
사랑하면 좋을까?	사랑하면 뭐가 좋을까?	0
화장으로 여드름이 가려질까?	여드름 피부 화장으로 가릴까?	0
영화 보러 왔어	영화보고 왔다	0
남자친구가 너무 조급해.	남자친구가 성격이  너무 조급해.	0
아직도 공부할 게 많아	또 공부해야돼	0
군대 기다려 주려고	군대 기다려도 될까	0
말하는 거 귀여워	말하는 거 너무 귀여워	0
폰이 점점 느려지는듯	몇 년 되니까 폰 느려지는듯	0
썸녀한테 크리스마스 선물 오바인 부분?	눈치 보임.	1
자꾸 설사해	자꾸 설사해	0
경제력 보는게 이기적인거야?	계속 좋아하는 거 무리일까요.	1
새해 치킨복 많이 받으세요	절하고 세뱃돈 받아야지	1
썸타는 중인데 답 잘 안보내	썸타는 사람이랑 연락이 잘 안돼	0
재밌는거 할 줄 알아	재밌는거 없나?	1
넘치는 사랑 받고 있어	내가 생각해도 넘치는 사랑 받고 있어	0
카톡하는데 자꾸 웃음 나.	카톡하는데 자꾸 웃음 나.	0
남자친구가 표현이 너무 없어. 너무 무뚝뚝해.	남자친구가 표현이 너무 없어. 너무 무뚝뚝해.	0
남자친구가 자존심이 너무 쎄	남자친구가 자존심이 너무 쎄	0
대리님은 갈구는게 취미인 듯	대리님이 너무 갈궈	0
전 왜 이렇게 안똑똑할까요?	전남친 여친 생겼네	1
꿈에 나온 여자를 어떻게 찾을 수 있을까?	꿈에서 만나자	1
스케일링 하기 귀찮아	스케일링 하러 가야지	0
기능 좀 알려줘봐봐	할 줄 아는거 뭐야?	0
사랑 못 받는 느낌에 우울해	사랑 받지 못한다는 느낌 때문에 우울해	0
좋아하는 거 기준이 뭐임?	좋아하는 감정이 뭐예요?	0
여자친구가 너무 좋은데 자존감을 너무 떨어뜨려.	여자친구가 너무 좋은데 자존감을 너무 떨어뜨려.	0
첫데이트 하자마자 차임;?	첫사랑이자 5년연애	1
나 혼자 여행 왔는데 괜찮네	혼자 여행 왔어	0
자전거 데이트 어떨까?	자전거 데이트 어떨까?	0
그녀를 다시 찾았습니다	그녀를 되 찾았습니다	0
너무 편해도 안 좋아	너무 편해진 거 같아	0
능력치 제로	능력이 없는 거 같아	0
여자친구 오지랍 장난 아님	여자친구 오지랍 장난 아님	0
그래 오늘 내가 찼어	그런 여자가 있었지하고 잊혀지겠지	1
썸남이 연락이 안돼	썸남이 연락을 안 받아	0
전여친 한테 두달만에 연락이 왔어.	전여친한테 남친이 생겼네	1
물건 사는것도 힘드네	쇼핑했더니 힘드네	0
어떻게해 늦잠 잤어	오늘 또 늦잠잤어	0
쉬운 게 하나도 없네	쉬운 게 없네	0
누구에게나 친절한 남자 위험해?	누구에게나 친절한 남자 위험해?	0
집들이 해야지!	집들이 초대해야겠다.	0
술 먹을 줄 알아?	술 잘하니	0
그냥 쉬고 싶다.	격렬하게 쉬고 싶다.	0
어둠에서 나와야 할 듯	이제 어둠에서 나오려고 해	0
회사만 가면 우울해	회사만 가면 우울해	0
애버랜드 가고 싶어	놀이동산 가고 싶어	0
몸이 여러 개면 좋겠다	내 몸이 여러 개 였으면 좋겠다	0
재회 후 이별 !	재회를 한다해도	1
로맨틱한 사랑을 원해	로맨틱한 사랑하면 안 되나	0
중국으로 진출해볼까?	나 중국간다.	1
짝사랑하는 사람한테 선물 주면 부담될까	짝남한테 선물 주면 부담스러워할까	0
축의금 보통 얼마내?	축의금 얼마 내지?	0
이제 사진 지운 이유는?	이제 이 곳 올 일 없을거 같네	1
감정이 쓰레기통처럼 엉망진창이야	나 감정쓰레기통이었나봐	0
하하하~ 유쾌하네	정말 오랜만이네	1
책상 정리할거야	싱크대 설걷이 너무 많아.	1
좋아하는 남자애한테 어떻게 관심 표현함?	좋아하는 마음을 전할 수 있을까.	1
사랑은 주고 받는 거지?	사랑은 주고 받는 거지?	0
동상 걸릴거 같아.	동상 걸릴 뻔했어	0
아 아른거려	아! 어찌해야 되나	1
물 많이 마셔야 돼	물 자주 마셔야지	0
신용카드 다 없애야겠어	이 놈의 신용카드 다 없애야지	0
오늘 야근인가	야근각	0
여자친구가 게임을 너무하는게 고민이야.	여자친구가 게임을 너무하는게 고민이야.	0
운동 갔다 다칠 뻔했어	운동하다 다칠뻔	0
나 기억했으면 좋겠다	나 사랑할 자격 없는 사람이야	1
인정받고 싶은데 어떻게 해야돼?	인정받으려면 어떻게 해야돼?	0
남자친구가 내 편을 안 들어 주고 조언만 해줘	남자친구가 내 편을 안 들어 주고 충고를 해줘	0
보고 싶다고 하네	보고 싶습니다	1
잠을 못 잤더니 힘들다	잠을 못 잤더니 너무 졸려	0
사랑니 나는 것 같아 아파	사랑니 나나봐	0
대우를 안해줘	대우가 별로야	0
진짜 대단하다.	멋진 사람인지 알았지만 정말 대단하네	0
내가 진짜 즐길 수 있을게 뭘까	진정으로 즐거운 게 뭘까?	0
썸녀가 약속 시간을 안 지킴.	약속 시간을 안 지킴.	0
무시 당했어	이상한 사람 너무 많은 것 같아	1
사람들은 내가 그 남자를 좋아하는 거라는데 난 이해가 안가.	나는 그냥 그 사람 칭찬한건데	1
전 애인 만났어. 	전애인 만났는데 모르는 척할까?	0
좋아하는 사람이 하는 행동에 하나씩 의미 부여하는게 짜증나.	좋아하는 사람이 하는 행동에 하나씩 의미 부여하는게 짜증나.	0
아날로그 감성 카메라 샀어	필름 카메라 샀어	0
좋아하는게 이렇게 힘든건가	헤어졌는데 아직도 좋아	1
만나자고 약속 잡는 것도 귀찮아	누굴 만나는 것도 귀찮아	0
이러다 또 흐지부지하고 말겠지	항상 흐지부지야	0
사랑 지키는 방법	사랑하는 사람이랑 놀러 다니고 싶다.	1
간장치킨 시켜야지	치킨 시켜야지	0
헤어진지 10일째.	헤어진지 10일 지났네	0
지나간다.	지옥같은 5월이 다가 오네ㅜㅜ	1
친한 동생인데 짝사랑하는 것 같습니다.	친한 동생인데 짝녀가 된 것 같아요.	0
내 마음을 보여주는 게 어려워	내가 누굴 좋아하는지 헷갈리면 이상해?	1
연락해보고싶네	연애 중 주고 받았던 문자 다시 보면 눈물이 나	1
어떤 연애 하고 싶어?	어떤 연애 하고 싶어?	0
핸드폰 패턴 궁금해	패턴 풀어볼까	1
시어머니가 나만 미워하는 것 같아	시어머니가 차별해	0
짝사랑하면 어떤 기분이야?	짝사랑하면 어떤 기분이야?	0
돈 없어도 갈 수 있는 데이트 코스	돈 안드는 데이트 코스	0
집들이 어떻게 해	집들이 하기 싫어	0
나 자꾸 놀리는 애가 있는데 나 좋아하는건가.	자꾸 놀리는 애가 있는데 나 좋아하나.	0
7년이라는 세월 함께한 애인과 이별하게 되었습니다.	8년 긴 만남의 끝은 힘드네	1
둘이 사귀는 거 같애	나 몰래 사귀는 거 같애	0
헤어져야 하나.	헤어졌는데 가끔 궁금해져	1
남의 눈을 너무 신경써	여자친구가 남의 눈을 너무 신경써	0
남자친구에게 고민이나 속사정을 어디까지 얘기해?	남자친구의 학력이 너무 높아서 내가 부족해 보임	1
앞으로 뭐 해먹고 사냐	미래에 대한 고민	0
썸 타는 사람 이름 뭐라고 저장할까?	썸 타는 사람 이름 어떻게저장할까?	0
너무 힘들다	외로워	1
나만 반친구 없어	반에 친구가 없어	0
택배가 안 와	택배 기다리고 있어	0
현실의 벽	혹시나, 역시나	1
자장가 불러 달랬더니 불러줬어	자장가를 불러준 사람	0
헤어진지 1년되가.	헤어진지 이제 5개월.	1
한달동안 대답이 없는게 아직도 생각하면 비참한데	한달이 넘었지만	1
기분 꿀꿀해	오늘 울적하다.	0
마음이 변할까봐 두려워	내 마음도 언젠가는 변할까	0
남자친구가 짠돌이라서 돈 쓸 때 엄청 아까워해	남자친구가 짠돌이야	0
배가 넘넘 고파	배고프다.	0
그 사람이 날 좋아할리는 없겠지?	그 사람이 날 좋아할리는 없겠지?	0
먹고 자고 먹고 자고	먹고 자고	0
한복 빌려도 예쁠까	한복 맞출까 빌릴까	0
사랑의 묘약 같은 거 있나?	사랑의 묘약 필요해	0
짝남은 나한테 관심이 없는 것 같애.	짝남은 나한테 관심이 없는 것 같애.	0
오늘 나 좀 잘생겨 보인다.	나 오늘 따라 잘생겨 보이네	0
썸 끝난거지?	썸 끝난거지?	0
매운 닭발 먹고 싶다.	매콤한 닭발 생각나	0
여자친구가 내 의견 안 들어	여자친구가 내 의견 안 들어	0
술 안 먹으면 친구랑 뭐하지	술 먹는 거 말고 친구랑 뭐하지	0
도서관 앞자리 사람 괜찮다.	도서관에서 괜찮은 사람 봤어	0
먹고 나니까 졸리당	많이 먹었더니 졸려	0
사귄지는 며칠 안됐었지만	사람은 감정적인 동물이라	1
설렘이 사라진 거 같아	설렘이 없어	0
여자친구랑 피시방데이트도하고싶은데 어떻게 말을 할까?	여자친구랑 피시방데이트도 하고 싶은데 어떻게 말을 할까?	0
싸우면 자꾸 잠수를 탄다 답답해	싸우면 잠수타는 사람?	0
썸 타는 여자 만나기로 했는데 편하게 입어도 됨?	회사에서 어떤 사람이랑 자꾸 눈 마추쳐.	1
화장실 가고 싶어	화장실 계속 가고 싶어	0
손가락이 원망스럽네ㅜㅜ	수신차단의 의미	1
학생일 때 썸 괜찮을까	학생일 때 썸 괜찮을까	0
우리 다시 만날 수 있을까?	우리 다시 만날 기회가 있을까	0
짝녀랑 약속 파토 났어요.	짝녀랑 약속 파토 났어요.	0
카페나 갈까?	예쁜  카페 찾아가 볼까?	0
바쁘게 사는게 나쁘지는 않네	받아들여야지	1
이별의 고통 해결책.	이별의 아픔이 있는데 몸까지 아파서야	1
나 누구게?	나는 누구인가	0
도시락 싸는 거 귀찮은데 사먹을까	점심 도시락 싸는 거 귀찮다	0
공복이라 신경이 예민해져	공복이라 예민해	0
헤어지고서 10개월동안 4번 봤네.	헤어지는거 잘하는사람들 부러워	1
안경 쓰는 남자애 좋아하는 남자 있어?	혼자가 편하다는 짝녀에게 들이댔음.	1
나 왜 사랑해?	왜 나를 사랑해?	0
소개팅은 나한테 너무 어색하더라	소개팅 했는데 너무 어색하더라	0
원래 장난 잘 치는 성격인데 짝남 앞에서 넘 떨려서 노잼 돼.	원래랑 다르게 짝남 앞에서 넘 떨려서 노잼 돼.	0
내 나이 어떻해	내 발등 내가 다시 찍었네	1
따뜻한 봄이 다시 왔네 ㅎㅎ	딱한번만 생각해보세.	1
좋은 하루였어	주말이 참 힘들겠어	1
보통 썸이면 밀당해?	썸이면 보통 밀당하나?	0
책 팔 수 있는 곳 알려줘?	책 어디다 팔아?	0
맞지 않더라도 대화로 잘맞아갈수 있을까?	조금씩 대화로 잘 맞을까?	0
제주도로 떠나야겠다.	떠나요~ 제주도~	0
절대불공평	세상은 불공평해	0
그를 생각하면 할수록 내가 비참해.	생각할수록 내가 비참해.	0
배려 없는 사람 어떡해?	배려 할 줄 모르는 사람 어떡해?	0
몇 반 될지 궁금해	반 배정 잘 될까?	0
잠수타는거 너무 짜증나	아 좀 전화 좀 받으라고	1
또라이들 짱 많아	또라이가 너무 많아	0
안나가고 뒹굴거리고 싶어	아무것도 안하고 집에서 뒹굴거리고 싶어	0
좋아하는 애가 1년만 기다려 달라는데 어쩌지.	좋아하는 애가 1년만 기다려 달라는데 어쩌지.	0
전여친 꿈을 꿧어	전여친에게 다시 연락이 오면	1
택시비 아까워	택시비 많이 나왔어	0
마라톤 출전할까	마라톤 나가볼까	0
선생님이 나만 미워해	선생님이 나한테 왜 그럴까?	0
애를 나혼자 키우는 것 같아	혼자 해야 돼	1
주말인데 연락해볼까?	주말인데 연락해볼까?	0
2주가지나가네	30살 막바지의 이별	1
선생님이 차별하는 것 같아	선생님이 친구랑 차별해	0
좋아하는 사람이 단톡에서 다른 남자한테 관심 있는 것 같이 보여요.	좋아하는 사람이 단둘이 있는 걸 부담스러워해요.	1
주말이네	주체가 안된다	1
돌아버리겠다. 진짜	돌겠다	0
여자들은 착한 남자를 좋아하나요?	여자들은 보통 착한 남자를 좋아하나요?	0
휙 떠나고 싶다	여행가고 싶다	0
피부가 거지같아	피부 관리해야지	0
드디어 정리했네	따끔하게 혼내 줘	1
썸 타는데 원래 이렇게 적극적이야?	썸 타는데 원래 이렇게 적극적이야?	0
뭐라고?	설명 좀 해봐	0
우리 사랑이었을까?	우리 사랑이었을까?	0
답이 없는 과정	대체 본심이 뭐라는 건데.	1
뭣이 중한지 모르겠어	뭐가 중요한지 모르겠어	0
여자친구가 술만 마시면 필름이 끊기는데 너무 걱정돼.	여자친구가 술 마시면 필름이 끊겨서 너무 걱정돼.	0
이별. 냉정해진다	이별. 지쳐버렸나	1
의심되는데	의심가는 사람이 있는데	0
짝사랑 중인데 나혼자 치정 로맨스야.	짝사랑 중인데 나혼자 치정 로맨스야.	0
제사를 너무 많이 해	제사 없어졌으면	0
썸 타는 사람이랑 밥 먹기로 함	썸 타는 사람이랑 밥 약속 했어.	0
다시 만났는데 이제 정말 끝	재회 후 헤어짐	0
다음에 또 만나자	다음에 봐	0
우리 이것만은 잊지말자	우연히 길거리에 만나면 인사를 해야 하나?	1
이제 어떡하나	나 어떡하나 이제	0
식욕폭발해서 폭풍 먹방 찍었어	식욕폭발	0
짝사랑만 하다보니 이 세상에 나 혼자인 것 같네.	짝사랑만 하다보니 이 세상에 나 혼자인 것 같네.	0
나도 좀 살게 연락 좀 하지마	나를 사랑한 그사람에게 해줄수있는것	1
사랑에 빠지면 티가 나?	사랑에 빠지면 티나?	0
사귀고 나서 환장이 깨졌어	사귀니까 오히려 환장이 깨졌어	0
얼굴 작은 거 부러워	얼굴 엄청 작은 거 부러워	0
원래 다 이런거겠죠	위로 좀 해줘	1
참 정말 속이 뒤집어지고 구역질 나오고 미치겠네	참다 참다	1
노트북 백업 안까먹고 해야지 	컴퓨터 백업해야지	0
안경 벗으니까 훈훈하더라	안경 벗었는데 완전 훈남	0
남친이 나보다 눈물이 더 많아	남친이 나보다 더 잘 울어.	0
집 망한 거 같은데	우리집 망한 거 같은데 나 어떡하지?	0
문득 달력을 보니	문자 보내 놓은지 어언 한 달.	1
친구에서 연인이 되려면	친구에서 연인이 되려면	0
연애할때 자유를 원하는 상대에게 얼마나 자유롭게 해줘야하나.	연애할때 자유를 원하는 상대에게 얼마나 자유롭게 해줘야하나.	0
학교 짝이랑 썸 타는데	학교 짝이랑 썸 타는데	0
좋은 아침	굿모닝	0
친구들이랑 비교하는거 짜증나	친구가 너무 잘하니까 내가 작게 느껴져	1
오늘 하루도 잘들 지내셨나	오늘도 계속 생각나네	1
날씨가 좋네	날이 많이 추운데.	1
짝녀가 공시생인데 기다릴까요?	짝녀가 공시생인데 기다릴까요?	0
이렇게 끝이났네	끝인거겠죠?	0
카톡프로필~~~보고왔는데.	크리스마스가 더 가까워지니까 속이 답답해지네	1
집들이 하라네	집들이 해야겠지?	0
정말로 사랑한다면	정신과 방금다녀와서 처방전 받고 왔어.	1
남자들은 몇 년씩 혼자 짝사랑 할 수도 있어?	남자친구 만나고 왔어	1
남친 생일선물 뭘 주면 좋을까	남자친구 생일인데 뭘 줄까	0
짝남한테 같이 공부하러 가자고 해볼까?	짝남한테 같이 공부하러 가자고 해볼까?	0
아.벌받고 있는거네	아름답게 헤어지고 회사 그만둔 전남친	1
생각보다 오늘 너무 춥네	오늘 생각보다 춥네	0
내가 이렇게 또 불효를 한다.	내가 불효녀야	0
여친에게 운동을 하자고 어떻게 돌려말하지.	운동을 하자고 어떻게 돌려말하지.	1
학교 다니는 것도 힘드네	통학 힘들다	0
진짜 좋아하는 애가 생겼으면 좋겠어.	진짜 좋아하는 애가 생겼으면 좋겠어.	0
취뽀하고 싶다	취직이나 했으면	0
결혼이나 하지 왜 자꾸 나한테 화 내냐구!	스타트업하면 위험할까	1
면접 잘 볼 수 있을까	혼자 잘 살 수 있을까?	1
썸남한테 빼빼로 줄까?	썸남한테 빼빼로 줄까?	0
웃는 모습이 예쁜 사람	웃는 모습이 예쁜 사람	0
아침에 들을 노래 뭐가 좋을까	아침에 들을 노래 추천해줘	0
썸녀한테 여행가자고 해도 됨?	왠지 눈치 보임.	1
3박4일 정도 놀러가고 싶다	3박4일 놀러가고 싶다	0
남자 친구가 절 사랑하는걸까요	그 사람이 절 좋아하는걸까요?	0
어제 헤어졌습니다	어제는 그녀의 결혼식.	1
정말 고맙다 귀염둥아	고맙다	0
죽고 싶은 심정에 상담을 청합니다.	죽을거같죠?사람은 간사하네	1
14년의 기나긴 이야기.	1년 9개월 의 연애 종지부.	1
동생이랑 대판 싸움	동생이랑 싸웠어	0
친구가 배아플 정도로 잘 됐어	친구가 잘되니까 배 아픈 거 같아	0
명절 선물 알려줘	명절 선물 뭐하지	0
친구 따라다녀야겠다.	친구 따라 강남가나	0
이별너무 힘든네	이별보다 더 아프네	1
좋은 사람 같아서 놓치고 싶지 않아.	좋은 사람 같아서 놓치고 싶지 않아.	0
썸 탈 때 무슨 말하지	썸 탈 때 무슨 말해도 어색해	0
여사친이 여자로 느껴질때 있어?	여자 사람 친구였는데 갑자기 여자로 느껴질 때 있어?	0
5년 만났는데 매일 보고 싶어	5년 만났어	0
소문이 안 좋아	이상한 소문이 돌아	0
당신도 저만큼 아팠으면 좋겠습니다.	더 많이 좋아하고 덜 많이 좋아하는 거 그만합시다	1
썸탈때 카톡	썸탈때 카톡	0
시각한데 웃겨	웃으면 안되는데	1
매일매일 사랑해	매일매일 더 사랑해	0
최근에 헤어졌어	추억들을 하나씩 보내며	1
사랑하는 사람을 계속 기다려야 할까요?	그 사람 계속 기다려야 할까요?	0
아무말이나 하자	내 얼굴 어때?	1
쓰레기기는 또 언제 치워	쓰레기 언제 비워	0
너 좀 무서워	아 깜짝 놀랐다.	1
거지됐어	나 그지임	0
태몽꾼거 같아	태몽꿨대	0
잘해줬더니 더 해달래	잘해주고 싶었는데 그러지 못했어	1
중국 출장 가야할 수도 있어	중국 발령 날 수도 있어	0
이야기 듣고 있었는데 제 얘기 같았어요	제 얘기 같아요	0
그녀의 행복을 진심으로 빌어주는 날이 올까	그동안 보내왔던 시간.	1
남편이 바람을 피우는 것 같아.	요즘 남편한테 사랑받는 느낌이 안들어요	1
꽃게탕 맛있다.	꽃게탕 진짜 밥도둑	0
제 잘못입니다	제가 어떻게 행동해야할지 모르겠어	1
이렇게 또 혼자 좋아하고 이별하고.	혼자 좋아하고 이별하고.	0
좋은데 차갑게 대하게 돼	썸인데 자꾸 냉정하게 말해	0
옷 많은데 입을 게 없어	뭐 입지	0
내 기준 괜찮은 사람 발견했는데 남친 있는지 물어봐도 돼?	내가 그사람한테 필요했으면 좋겠어	1
잠수타고 연락 안돼	잠수이별인가봐	1
셀카 좀 잘 찍고 싶다	셀카 잘 찍고 싶다	0
성공하고 싶다	나 잘 살 수 있겠지	0
머리 스타일 추천	머리 어떻게 깎을까?	0
남친이 사랑하다는 말을 엄청 자주 해요	사랑 앵무  키우고 싶어	1
남자친구가 나쁜 의도는 아닌데 표현이 너무 서툴러.	남자친구가 표현이 너무 서툴러서 짜증나게 해.	0
가스비 너무 많이 나왔다.	가스비 장난 아님	0
감히 나를 무시하는 애가 있어	나 은근 무시하는 애 있어	0
키 큰 남자 만나고 싶어	키 큰 남자 만나고 싶어	0
술한잔 해야 하루가 가	쉽지않은 날들	1
오해하는 거 같은데 어떡하지?	오해로 싸움이 시작됐어	1
혼자 좋아하는게 이렇게 힘든 적은 처음이에요.	혼자 좋아하는게 이렇게 힘든 적은 처음이에요.	0
내일 만나자고 해볼까?	내일 만나자고 연락해볼까?	0
선택 장애 같아	선택 장애 있는 거 같아	0
이렇게 또 늙어간다	하루하루 늙어가	0
여자친구의 이성친구가 고민이야.	여자친구의 이성친구가 고민이야.	0
싸우면 연락이 안돼	싸우면 연락 안 받는 사람 어떻게 해?	0
나 바본인가 봄	바본가봐	0
나한테도 관심 있어 보이는데 연락해볼까?	관심 있는 것 같은데 연락해볼까?	0
아. 상담 좀 해 줘	아름다운 사랑도 아니고 이건 뭐.	1
딸기 먹을래	딸기 먹어야지	0
여친이 맨날 욕해	여자친구가 맨날 욕해	0
이사 가야 할 것 같아	이사가야돼	0
무슨 말이 필요하겠니	무뎌진줄 알았는데	1
철이 빨리 든 거 같아서 좀 그래	너무 빨리 철 든 거 같아서 마음이 아파	0
환승이별이란걸 알게됐습니다.	회복되는게 하루하루가 다른거 같아!!	1
마지막인가봐	만나고 왔는데 혼란스러워	1
죽을것같아	증오	1
욕을 퍼붓고 왓어	우리는 15년째 이별중입니다,	1
사랑하는 사람이 생겼어	그 사람이 너무 좋아	0
선 결혼 후 연애 해도 될까?	결혼하고 나서 연애 해도 될까?	0
요즘따라 아침이 너무 힘드네	우리 사랑은 가벼웠던 거겠죠.	1
썸타는데 갠톡 안하면	썸타는데 갑자기 톡 안하면	0
여자친구가 자꾸 구속해	여자친구가 구속해	0
랜선 연애 중	랜선 연애로 이야기 시작	0
다 끝났네	다 잊고 살아야	0
쫌 부담스러운데	차단인줄알았는데	1
1000일 만난 여자친구와 이별	10년 연예의끝	1
헤어진 여자친구가 꿈에서 밥을 해주고 가네.	헤어진 여자친구의 생일입니다.	1
뭐 좀 물어 봐도 돼	뭐 물어볼까	0
절친 만나고 싶어	친구랑 더 친해지고 싶어	0
썸타고 싶어요	썸이라도 타고 싶어요	0
연애보다 썸이 좋아.	연애보다 썸이 좋아.	0
그녀는 이별했지만 전 아직 슬픈진행중	그녀를 만났던 카페에서 탈퇴했어	1
사랑이 뭐가 대수라고	사랑이 뭐 대순가	0
믿지 말껄	믿는 게 아니었어	0
썸 탔던 애 친구해도 되나	썸 탔던 애 친구해도 되나	0
혼인신고했어 이제 유부녀	혼인 신고 하고 선물도 받았어	0
괜찮다가도 한번씩 마음이 저려오네	괜찮아졌다가 다시울컥하네	0
2년의 연애에 이별이란 종착역!!	2주가 지났어	1
결혼하면 다 끝일 줄 알았는데	결혼하면 끝일 줄 알았는데	0
하라고 할때는 공부하기 싫었는데.	어렸을때는 공부하기 싫었는데 지금은 하고 싶네	0
여자친구가 작은 일까지 다 기억해	여자친구가 너무 다 기억해	0
반지 호수 물어볼까	반지 호수 모르는데	0
정말 상처가 잡혀지질않으니 지칩니다	정말 연애하고싶지않네	1
남자친구가 갑자기 군대간대	갑자기 남자친구가 군대간대	0
중국어 배울려면 학원 다녀야 할까	중국어 학원 다녀야 하나	0
짝남이 너무 좋은데 패션센스가 별로야.	짝남이 너무 좋은데 패션센스가 별로야.	0
오로라 보러 여행 가고 싶다	오로라 보러 가고 싶다	0
결국 핸드폰 번호 바꿨어	결국 헤어지자고 했어.	1
내가 이상한건가?	내가노력해 봐도.	1
회사에는 왜 친구 같은 사람이 없을까	후련하달까	1
짝남을 반에서 공개적으로 좋아하는게 나을까요?	짝남을 반에서 공개적으로 좋아하는게 나을까요?	0
이게 바로 첫사랑인듯	첫사랑인듯	0
미련인건가.? 바보인건가	미안해	1
썸남인데 모텔 가자고 함. 어떻게 거절해?	썸남인데 모텔 가자고 함. 어떻게 거절해?	0
썸인 거 같은데 연락이 안돼	썸인 거 같은데 연락 안 하면	1
요즘 눈에 띄는 남자애	요즘 눈에 띄는 남자애가 있는데	0
낚시 안 해봤는데 재미있어 보인다	낚시 안 해봤는데	0
아픔도 이제 안녕	안 맞는다면서 헤어진 우리	1
오늘 만나기로 했는데 빈손으로 나가?	오늘 만나기로 했는데 빈손으로 나가?	0
주식이 떨어졌어	주식 망했어	0
코인노래방 가서 스트레스 좀 풀어야겠다.	코인노래방 가야지	0
노는 것 좋아하는 여자 이쁜데 좀 그래.	너무 잘 노는 이쁜 여자 좀 그래.	0
썸 끝나고 잡아도 될까	썸타다가 끝나는 거 같은데 잡아도 될까	0
썸 탈 떄 남자가 좀 더 쓰는게 맞아?	썸 탈 때 남자가 돈 더 쓰는게 맞아?	0
결혼하니까 이렇게 행복해도 될까 싶어	결혼한지 반년인데 이렇게 행복해도 될까 싶어	0
보고 있으면 아직도 설레	아직 보고 싶고 설레고 그렇다	0
지난 나라사랑 신문을 다시 보고 싶습니다.	국민은행 나라사랑후불교통카드 20%할인	1
학생 데이트 코스 추천	학생 데이트 코스 추천	0
연애 고수 되려면?	연애 고수 되는 방법?	0
한자 공부도 좀 해야 되는데.	한자 공부해야지	0
조급하고 초초하다	자꾸 조급해져	0
밥 뭐 먹을까	오늘은 뭐 먹을까?	0
셀프웨딩이 유행이래	속이 후련하네	1
두달이 되었네	두번 다시는 마주치고 싶지 않아여	1
하 너무 힘들어서 그냥 투덜투덜	하루 겨우 참고 또 문자 보냈네.	1
스타트업에 가도 될까?	스타트업에 취직해도 될까?	0
그녀도 내 생각을 할까?	내 생각을 할까?	0
여름 휴가 어디가 좋을까	여름 휴가 어디가지?	0
우산이 없는데 빌릴까	우산빌려달라고 해볼까?	0
소개팅하고 애프터 바로 와?	소개팅하고 바로 애프터 연락 와?	0
뽑은 인형 짝녀에게 주면 좋아할까?	인형 뽑았는데 짝녀에게 주면 좋아할까?	0
나도 이제 아재인가	나 아재인가	0
여사친이랑 연락이 끊기지 않고 너무 잘되는데 그린라이트일까?	여사친이랑 연락이 너무 잘되는데 그린라이트일까?	0
지금의 나에겐 없는 너의 일상	지난 주말부터 또 후유증이	1
좋은 관계를 맺는 방법	좋은 관계를 맺는 방법	0
사랑하는 사람 잊는 법	사랑하는 사람 잊는 법	0
반가워요 반갑구만	반가워	0
막말 너무 막해	나한테 막말 좀 안 했으면 좋겠다	0
말이 안 통해	소통이 안돼	0
사람들이 그런 말 하더군	사랑 없이도 잘 살았는데	1
영화관 혼자 왔어	혼자 영화보러 왔어	0
오늘 보름달이다.	보름달 떴다	0
마음이 자꾸 쓰이네.	신경이 자꾸 쓰이네.	0
사람은 다른데 연애는 비슷해	연애는 다 비슷해	0
편한 주말 보낸지가 언제냐	시어머니 스트레스	1
연애하는데 사랑받는 느낌을 안받아.	사랑받는 느낌을 안들어.	0
나 좋아하는 애가 매일 선톡 걸다가 갑자기 톡을 안함.	톡하다가 조용해	0
디퓨저 선물 해줄까?	디퓨저 선물 해줄까?	0
천사같은 여자친구가 떠나갔어 마음이 너무 아픕니다.	첫사랑은 안되는건가	1
삼년 사랑하고 이별한지 몇 시간	상대방의 후폭풍 따위는 없어	1
결혼해야 하나	결혼하면 좋아?	0
결혼해도 계속 좋을까?	결혼해도 이렇게 계속 사랑할까	1
학교에서 맞았어	학교폭력 당하고 있어	0
부부싸움은 칼로 물 베기라더니	부부싸움은 칼로 물 베기라더니	0
아무리 열심히 해도 타고난 사람은 못 따라가겠지?	아무리 열심히 해도 선천적인 건 못 따라가겠지?	0
일상의 추억	일주일이 너무 길어	1
싫은 건 아닌데	싫진 않은데	0
예비 시어머니가 이상해	시어머니될 사람이 진짜 이상해	0
남자친구가 집청소를 너무 안해.	남자친구가 집이 너무 더러워.	0
아직도 기억 속에 생생한데	아직도 멍청하네	1
저기	이놈	0
세상에 영원한 것은 없다.	소중한 것을.	1
현금영수증 잊어 먹었어	현금영수증 또 까먹었다	0
비웃는 니 웃음소리 기억나	너의 비웃는 소리가 기억에 맴돌아	0
여자친구가 취업하더니 변하더라	취업하더니 변하더라	0
남자친구 이성친구가 많아	남자친구 여사친이 너무 많아	0
정답이 뭘까	답이 어디있을까?	0
짝남한테 잘 보이고 싶은데.	짝남한테 잘 보이고 싶은데.	0
다시 우울.	다시 차단해야만 하는군	1
헤어진 여자친구 생일전에 잡아보려구	헤어진 여자친구에게 새로운 남자가	1
매달렸다 차였어	매번 왜 이렇게 남는게 후회인지 모르겠네	1
외로워	요즘 다시 쓰리다	1
날씨가 갑자기 추워져서인지.	날씨가 참 안도와주네	1
이제 헤이진지 5일차네.	이제는 연락도 없는 너를 그리며	1
휴양지 추천!	휴양지 가고 싶다	0
손수건 안 가지고 나왔어.	손수건 가지고 다닐걸	0
오늘은 별도 안 보이네	별이 안 보여	0
좋아하는 여자가 최근들어 연락이 늦는데 나한테 마음이 없는거겠지.	좋아하는 여자가 최근들어 연락이 늦는데 나한테 마음이 없는거겠지.	0
비싼 명품 이제 그만 사야겠어	명품 이제 사지 말아야겠어	0
부담스러운 기대 좀 떨쳐낼 없을까?	기대가 부담스러운데 떨쳐낼 수 있는 방법 있을까?	0
참견쟁이	참아내지 못하고 전화를 했습니다.	1
썸타다 지침	썸타다 끝났나	0
썸 타는 기간	썸 타는 계절이 왔나 봄.	0
미용실에서 너무 티 안 나게 머리를 잘라줬어	미용실 갔다왔는데 티가 안 나	0
친구랑 비교 돼	친구랑 나랑 자꾸 비교하게 돼	0
간만에 떨리니까 좋더라	오랜만에 떨려서 좋았는데	0
제가 제 복을 찬거겠죠 .	제발 머리가 나빠졌음 좋겠습니다.	1
취향 알고 싶다	취향 알고 싶다	0
반장 선거 나가볼까	반장 나가볼까?	0
신혼생활이 영원했으면	신혼 생활이 영원했으면 좋겠다.	0
썸만 타고 싶어. 사귀는 건 걱정돼.	사귀는 건 걱정돼.	0
오늘 무작정 찾으러가고싶은데 갈까?	오늘 이별했습니다	1
어떻게 서류에서부터 계속 떨어져	나 서류에서 광탈했어	0
신혼같지가 않아	신혼이 신혼 같지가 않아	0
짝남한테 은근슬쩍 좋아하는 티 내는 방법 좀.	짝남한테 은근슬쩍 좋아하는 티 내는 방법 좀.	0
헤어져야 할까?	헤어졌는데 자꾸 연락하네	1
쓰레기	쓰레기새끼	0
선물 뭘로 할까?	뭘로 선물할까?	0
좋아하는 남자애랑 다른 반 됐어.	좋아하는 남자한테 연락 하지 말자고 했는데.	1
셀프웨딩 어떨꺼 같아	셀프웨딩 해볼까	0
남친 요구가 점점 심해지는 듯	남친 요구가 점점 심해	0
싸웠는데 화해 어떻게 하지	싸웠을 때 어떻게 해?	0
친구에게 물어 봐야겠다	친구한테 물어봐야지	0
사랑해서 헤어진대	사랑하는데 헤어지자는게 말이 된다고 생각해	0
책상 리폼할거야	싱크대 리폼할거야	1
두번 다시 하기 싫은 헤어짐	두번째 주말이 지났네	1
싸게 팔길래 샀어	할인해서 샀어	0
"내가 더 사랑한다고 느껴져서 외로워요"""	마누라를 너무 사랑합니다	1
여자친구가 클럽을 간다면 어떻게해?	여자친구가 클럽을 간다면 어떻게해?	0
내 이름이 없어	내가 나에게 해주고 싶은 말	1
엇갈리는 느낌 싫다	엇갈리지 않았으면 좋겠다	0
짝남이 제 톡 안 읽고 프사 바꿨어요.	짝남이 제 톡 안 읽고 프사 바꿨어요.	0
물이 안나온데	단수래	0
억지로 붙였던 깨어진 도자기의 결말	언제쯤 무뎌질까	1
집들이고 뭐고 다 귀찮다	집들이 귀찮아	0
오랜만에 서점에 갔었어	서점에 들렀어	0
결국 헤어져서 울고 있어	헤어짐 ㅠㅠ	0
밖에서 먹으니까 더 맛있어	야외에서 먹으니까 더 맛있어	0
같이 있으면 힘든데 붙잡고 싶어	나를 힘들게 하는 사람인데 붙잡고 싶어	0
좋아하는 사람 오늘 못 봐서 진짜 우울하다.	좋아하는 사람 오늘 못 봐서 진짜 우울하다.	0
이젠 어쩌죠.	이젠 정말 끝이겟죠?	1
자취 선물로 뭐 많이 사나	자취방 가는데 선물 뭐가 좋을까?	0
괜찮다가.갑자기 ㅠ	괜찮아 진 줄 알았는데 오늘 펑펑 울었어.	0
연락올까?	연락죽어도 안올텐데 매일 기다려	1
대놓고 질린대	내가 질린대	0
카톡이 안와	카톡할 친구가 없네	1
진짜미칠꺼같네	집에서 웃고 떠들고 있지만	1
환기 좀 해야할까?	환기할까?	0
사랑한다고 고백해 볼까	"가족끼리 ""사랑해요""라는말 하는거 어색해"	1
건강이 최고지	요즘 정말 돈이 없어	1
콧물 질질	콧물 나네	0
나 진심인데	나는 진심으로 좋아하는 건데	0
차라리 솔직하게 말해주지. 더 짜증나는건	착찹하네	1
내 존재를 알리고 싶어	내가 썸 깼는데 다시 연락하고 싶어.	1
어떨때 연인이 변했다고 생각해?	어떨때 연인이 변했다고 생각해?	0
커피 타기 귀찮아	커피 타는 거 싫다	0
모두 자기만의 고민이 있겠지	많이 못 봐서 아쉬워	1
잊어볼 마음에 다른 여자 만나고왔습니다.	잊을 수 없다는 거 이제 알겠네	1
파도가 잔잔하네	오늘은 파도가 잔잔하네	0
세상이 아름다워 보여	세상이 정말 아름다워 보여	0
썸타는 중인데 계속 먼저 연락해도 됨?	썸타는 중인데 계속 먼저 연락해도 됨?	0
존경할 수 있는 사람 만나고 싶어.	존경할 수 있는 사람 만나고 싶어.	0
운동 오지게 했어. 헥헥	운동을 너무 열심히 했더니 뻣었어.	0
내일 짝남이랑 영화보러간당.	내일 드디어 짝남이랑 영화보러간당.	0
썸 타는 여자애한테 벚꽃 보러 가자고 해도 돼?	흑기사 해주는 짝남.	1
나 짝남이 외국인인데 어떡해. 미치겠어.	나는 아직 고백안했는데 소문이 나서 짝남이 알게 됐어.	1
어떻게 해야돼?	어렵네	1
멋진 데 알아 냈어	근사한 곳 알아 냈어	0
짝사랑 하던 사람이 있는데 끝까지 포기 못할 것 같아.	짝사랑 하던 사람 못 잊을 것 같애.	0
말 거는게 어려워	처음에 말 걸 때 힘들어	0
좋아하는 사람이 행동하는 모든 게 좋아.	좋아하는 사람이 행동하는 모든 게 좋아.	0
늘 우울하다면 어찌하나요?	그 사람의  마음을 알고싶어	1
친구들이랑 맛난거 먹고 싶다	친구들이랑 맛집 가고 싶어	0
아까 누웠는데 잠이 안 와	불면증인가 잠이 안 와	0
썸녀가 짝녀 됐습니다.	회사에 좋아하는 남자가 생겼어 어떡하지?	1
면세점에서 쇼핑할거야	면세에서 뭐 사지	0
남자인지 여자인지 알려줘	남자친구의 바람으로 오늘 이별했습니다.	1
너무 연락하고 싶어서 여기에 써	헤어지면 나 혼자 잘 할 수 있을까	1
사랑하는 사람이랑 살고싶어	나도 사랑하는 사람이랑 살고 싶어	0
교회 갔다 만났어	교회에서 만났어	0
계절이 바뀌면	곧 1년인데 헤어졌어	1
바람 강제이별 너무 힘들어	바람피지마	1
아직 그리운 그대	아직도 꿈같고 너무 괴로워	1
무릎 아파	무릎 쑤셔	0
썸 타는데 머리 아파 신경쓰여.	썸 타는데 신경쓰여.	0
남자친구가 나를 너무 애 취급하는거 같음.	남자친구가 너무 애 취급하는거 같음.	0
에휴. 왤케 머리속에서 계속 멤돌까	여자가 떠가기전 하는 준비	1
썸남이 짝남 됐어요. 위로해 주세요.	썸남이랑 끝나고 짝남하기로 했어요 위로 좀.	0
사랑하고 사람이 달라졌어	사랑하고 사람이 변했어	0
안경테 바꾸면 인상이 바뀔까	안경테 바꿀까봐	0
메모하는 습관 필요해	메모하는 습관을 기르고 싶어	0
요즘 자꾸 까먹어	요즘 자꾸 깜빡깜빡해	0
좋아 하는 애한태 고백하는 방법좀	어떻게 사랑한다고 고백을 할까요?	0
썸 타고 싶어	썸 타고 싶다. 연애 말고.	0
지금 좋아하는 사람 있어?	좋아하는 사람 있어?	0
짝남 고민 들어줄래요?	짝남 고민 들어줄래요?	0
사진 참 못찍는 것 같아	그 사람 사진을 못지우겠어	1
생각할 시간도 없는 느낌	생각할 시간 조차 없어	0
여자친구가 화나면 말을 안 해.	여자친구가 화나면 말을 안 해.	0
라면 먹을래	라면 먹고 갈래	0
자꾸 궁금한데 집착일까	집착한다고 할까봐 문자 못하겠어	1
정말 . 냉정하네	정말 너를 받아준게 아니였어.ㅠㅠ	1
나도 아내가 있었으면	결혼하고 싶다	0
저주스럽다 모든게 다	전 여자친구 부친상 다녀왔어	1
출근하기 너무 오래 걸려	출근길 너무 힘들어	0
동거하다가 헤어질까봐 걱정이야	동거하는데 헤어질까봐 걱정이야	0
사랑하고싶어	사랑하고 싶어	0
이제 진짜 끝났어 슬퍼	이제 헤어진지 딱 한달	1
말수 적은 남자인데 썸타도 괜찮을까?	말수 적은 남자인데 썸 괜찮을까?	0
사랑꾼인 거 같아	아무래도 사랑꾼인 거 같아	0
정말 속상하고 답답하고 할 수 있는게 없네	정말 오랜만에 글을 쓰네	1
그 사람 취향 알면 선물 하기 편할텐데	선물 어떤거 좋아하는지 취향 궁금하다	0
나를 진심으로 좋아해주는 사람이랑 만날 걸.	나를 좋아해주는 사람이랑 만날 걸.	0
괜히 카톡했네.	군인이라 슬프네.	1
턱시도 잘 어울림!	턱시도 잘 어울림!	0
이별하려고 합니다	이별한지 20일 차.	1
나라 사랑 대출 문의	농촌사랑 전자상품권을 현금으로 교환하는 방법 있나요?	1
친구한테 미안하다.	친구한테 마음의 빚이 많아	0
아놔 동생이 약점 잡고 늘어지네 	동생한테 약점 잡혔어	0
나른하다	아무것도 하기가 싫어	0
웃게 만드는 너란 녀석	나를 미소짓게 만든 너	0
어떻게 해야 하는 거니	어떻해야 할까	0
충격.충격	카카오톡 대화명	1
왕따인가 봄	나 왕따야	0
용돈 벌써 없어	용돈 다 썼어	0
나는 좋아하는 게 뭘까	좋아하는 게 뭔지 모르겠어	0
어플로 만난 여자친구 계속 연애하는게 맞는걸까?	어플로 만난 여자친구 계속 만나도 될까?	0
심쿵하게 하는 방법	심쿵하게 하는 방법 따로 있나?	0
또 찾아갔네요	모든게 니멋대로	1
짝사랑 하는 여자한테 어떻게 말 걸지	짝사랑 하는 여자랑 편하게 이야기 시작하는 방법	0
썸녀 화이트데이 선물 뭐가 좋을까?	화이트데이 선물 뭐가 좋을까?	0
조금씩 무뎌져가나봐	조언 좀 해주세요 ㅠㅠ	1
누우면 자	침대에 누우면 바로 자	0
불안해	뭔가 자꾸 불안해	0
벌써 가족 같아	벌써 가족 같아	0
핸드백 선물 받았어	빽 선물 받았어	0
회사를 차리고 싶다	사업 해볼까?	0
출근시간 너무 오래 걸려	출근길에 벌써 지쳐	1
요즘에는 외국어도 잘해야하나봐	요즘에는 중국어도 잘해야하나봐	1
덕분에 스트레스 덜 받는 듯	긍정적으로 생각하자.	1
노트북 안돼	노트북 부팅 안돼	0
찜질방 가고 싶다	찜질방가서 땀 빼고 싶다	0
여행 왔는데 좋아하는 선물로 뭐가 괜찮을까?	연락 많이하는데 썸인지 모르겠어	1
쪼금 지겨워진 거 같아	쪼금 지겨워진 거 같아	0
목이 뻑뻑해	목이 칼칼해	0
설마했던 진짜 이별	세상 혼자인 기분	1
내 외모 맘에 안들어	외모에 자신이 없어	0
정말로 헤어졌네	정신병 걸릴 것 같네	1
살만해?	인생 살만해?	0
사랑을 표현해줬으면 좋겠어	좋다고 표현해줬으면 좋겠어	0
남자친구랑 데이트 어디 갈까	데이트코스 추천해 줘	0
4개월째.	4년 사귄뒤 이별. 어느새 5달이 다 되어가네여.	1
결혼 기념일 기념했어	덕분에 더 흥겨웠던 시간!	1
얼집 방학이래	어린이집 방학이래	0
발렌타인데이 선물 줄 사람이 없어	발렌타인데이인데 줄 사람이 없어	0
회사에는 왜 친구 같은 사람이 없을까	할 줄 아는거!	1
착각일 수도 있는데 서로 좋아하는 것 같으면 고백해?	착각일 수도 있는데 서로 좋아하는 것 같으면 고백해?	0
할말 다 했는데 실수한건가	할말 다 하고 사는 게 나빠?	0
고백 좀 하지	고백	0
여자친구가 일정 중에 연락못하는걸 이해못함.	여자친구가 업무 시간에 전화 못받는 걸 이해못함.	0
사랑하는 사람과 아침을 함께 맞이하고 싶어	그 사람이랑 함께 아침을 맞이하고 싶어	0
해주기 싫어	뭐 해주기가 싫어	0
드디어 데이트인데 뭐하지	첫 데이트에 뭐하지	0
자장면이랑 짬뽕 다 좋은데 어쩌지.	자장면도 먹고 싶고 짬뽕도 먹고 싶어.	0
다리 꼬면 안되는데 습관 안고쳐져	다리꼬지마	0
동성 친구들이 편해	동성이 좋아	0
의미부여	이 글을 끝으로 잊고 싶어	1
이별로 받아 들일게	이별 받아는 들이긴했는데	0
별사람이 다 있는 듯	별 사람이 다 있다고 생각하고 넘겨야 할 것 같아.	0
배고파 죽을 것 같아 힘이 없어	배고파서 힘이 없어	0
2년 정도를 만났는데 잘 이해가 안가	2년간의 단거리, 2년간의 장거리, 그리고 이별.	1
제주도 놀러 가고 싶다.	지리산 등반 하려고	1
썸에서 연애로 가는거 맞나요?	이거 썸인가	1
씻어도 냄새나는 거 같애	씻어도 냄새나는 거 같애	0
짝녀가 다른 남자를 좋아한대.	짝녀가 다른 남자를 좋아한대.	0
남편이 날 사랑하지 않는 것 같아. 이혼해야할까?	내 첫사랑이 날 기억 못 해.	1
하객이 없을 까봐 걱정돼	결혼식때 하객이 없을 까봐 걱정돼	0
자기 쓰레기 맞다고 잊고 살아가래	자꾸 보고싶어	1
이 상황이 싫다.	재회했다가 이별하고 	1
사랑해라고 말해줬으면 좋겠어	사랑한다고 말 좀 해줘	0
결혼 전에 준비할 게 많겠지?	결혼 준비하면서 못 보던 모습을 보게 돼	1
잘할 수 있겠지	나 잘할 수 있을까	0
왜 갈수록 더 생각나지	왜 남자가 여자가 하는 행동을하죠?	1
장수커플이야	장수커플이야	0
세상에서 제일 힘든 게 짝사랑인 듯.	세상에서 제일 힘든 게 짝사랑인 듯.	0
아픈 첫사랑	아휴~ 싱숭생숭한 하루	1
맛집 가고 싶어	맛집갈까	0
사귀고 나서 트레이닝복만 입어	트레이닝복만 입어	0
허허 맴찢.	헤어져야 하는걸 아는데 그사람을 보낼 수가 없네	1
5급면제도 나랑사랑카드 발급하나요?	아이콘 노래 사랑을 했다 별로인것같은데	1
2년 만에 연락 그후입니다 .	2년간 만난 여자친구와의 이별	1
사랑하기에 시간이 부족해	사랑은 나한테 사치야	1
있는 그대로의 나를 사랑하기	있는 그대로의 나를 사랑하기	0
또 스팸 전화다.	요즘 부쩍 스팸 전화 많이 와	0
그는 지금 무슨 생각을 할까?	무슨 생각을 할까?	0
본인을 좋아하는게 확실한 여자와 친구가 될 수 있어?	미안한데 사랑은 아닌 것 같아 친구로 좋은건데.	0
나도 비키니 입고 싶다	당당하게 비키니 입고 싶다	0
다시 태어나도 만나고 싶은 사람	데이트 비용은 보통 어떻게 내?	1
좋아하는 애랑 영화 볼건데 액션은 좀 그렇겠지?	좋아하는 애랑 영화 볼건데 액션은 좀 그렇겠지?	0
나 처음 연애해봐	나는 왜 사랑하는 사람에게 잔인했던가	1
남편이 츤데레 스타일이야	내가 그 사람을 좋아하는건지 아닌지 착각이 들어.	1
썸인가 아닌가	썸인가	0
예식장 취소했어	예식장 취소했어	0
새로운 마음으로 시작	새로운 마음으로	0
매주 월요일 그녀를 볼 수 있어.	매주 월요일이 되면 그녀를 볼 수 있어.	0
좋은 사람 있으면 소개시켜줘	좋은 사람 있으면 소개시켜줘	0
미세먼지 때문에 짜증나	미세먼지가 너무 많아서 짜증나	0
진급해야 할텐데	진급하고 싶어	0
술 먹고 싶어	술만 마시고 있어	0
새학기 필기구 좀 사야지	새학기 학용품 사야지	0
그 사람과 내 맘이 같을까?	그게 잘 안되네.	1
매주 화요일 그녀는 마주할 수 있어.	매주 화요일 그녀랑 함께 할 수 있어서 다행이다.	0
하루에도 몇 번씩 마음이 바뀌어	하루에 몇 번씩 헷갈리네	0
보고야 말았네.	보름밖에 안되었는데.	1
이별한지 이제 겨우 한 달	이별할때는 미련 갖지 않게 해주는게 좋겠어	1
소개받은 사람이랑 카톡으로 연락 중	소개받았는데 카톡으로 연락 중	0
밀당은 어떻게 해?	밀당은 어떻게 해?	1
화장품 없어 사야 돼	화장품 다 떨어졌어	0
미팅한다!	나 미팅한다!	0
이혼을 하고싶진 않는데 너무견디기힘듭니다 ㅠㅠ	인생 포기한 걸까	1
결혼 고민	결혼식 앞두고 고민이야	0
오래된 게 좋은 것도 있지	오래된 게 좋겠지	0
수상한 느낌이 든다	뭔가 수상한데?	0
모쏠인 사람 만나면 답답할까?	모쏠인 사람 답답할까?	0
코트 살까 말까	코트 살까	0
썸남인데 넘 귀여워. 어쩌지?	썸남인데 넘 귀여워. 어쩌지?	0
너 이름 있어?	누구세요?	0
이별을 하고.	이별의 마무리	1
사랑한다고 말해볼까?	사랑한다고 고백할까?	0
잘 다녀왔습니다	백만년만에 만난 친구랑 스테이크 먹었어	1
이별을 해야하나봐	이별의 아픔에서 벋어나는 방법	1
사랑은 영원해?	사랑은 영원하지 않지	1
말을 안하는 연애	거의 말을 안하는 데이트	0
연락만으로 썸 가능해?	연락해도될까?	1
하하 진짜 헤어지고 싶다	한달 됐네	1
상관 없는 이야기만 해	나랑 상관 없는 이야기들	0
친구의 친구를 사랑했네	친구의 친구를 사랑하는 거 같아	0
재회를 하긴 했었는데 다시 헤어짐	재회후 다시 이별	0
혼자 해야되는게 너무 많네	혼자 있으니까 혼자 할게 많네	0
너무너무너무 힘드네	너에게 보냈던 마지막 카톡.	1
미련덩어리 프사 모음	미련으로 붙잡아선 안되겠죠	1
7년만에 두번째 이별통보	7년사귄 남자친구의 유흥업소 방문사실을 알아버렸습니다	1
남자친구가 너무 똑똑해	남자친구가 너무 똑똑해	0
가끔은 혼자인게 좋다	혼자라서 너무 좋아	0
사랑 별거 없네	사랑 참 별거 없네	0
정말 힘들게 헤어졌습니다	정말로 이별하려고 준비합니다.	1
하고 싶은 게 하나도 없어	하고 싶은 게 없어	0
엠티 가는데 짝녀랑 같은 반 되길.	엠티 가는데 짝녀랑 같은 반 되길.	0
트위터 보면 다 행복해보여	SNS보면 나만 빼고 다 행복해보여	0
헤어지고 얼마 안됐는데 썸타는 거 가능?	헤어지고 얼마 안됐는데 썸타는 거 가능?	0
다 허무하다	사는 게 허무해요	0
비 오는 날	비 오는데?	0
사랑의 끝이 뭐야?	사랑의 끝이 뭐야?	0
첫시작이 잘못된 만남이였을까?	최악	1
외모는 내 취향인데 좋아하는 걸까?	외모는 내 취향인데 좋아하는 걸까?	0
용돈 벌써 다 썼어	용돈 넘 적어	0
혼수 얼마나들까?	혼수 얼마야?	0
비가오니 그런가	비 오네	0
이름 뭐야?	뭐라고 불러?	0
부모님이 갑자기 같이 살자 셔	혼자 살다가 갑자기 부모님 모실 수 있을까?	0
강원도 가서 살까?	제주도 가서 살까?	1
오늘 좋아하는 애한테 고백했는데.	오늘 좋아하는 애한테 고백했는데.	0
뭔가 말해봐	말해봐	0
좋아하는 거랑 사랑하는 건 어떻게 구분해?	좋아하는 거랑 사랑하는 거 차이점이 뭘까요.	0
파도 타고 놀고 싶어	파도 타고 싶어	0
어제 헤어지자했어.	어제 결국 이별	0
우리가 좋은데 왜 반대하시지	두 사람만 좋으면 되는줄 알았는데 아니었나봐	0
헤어지고 1주에 한번은 뭐라도 오네	헤어지고 나서 만나기로	1
나 오늘 개불쌍	나 쫌 불쌍한 거 같아	0
떡볶이 너무 많이 많들었다.	떡볶이 만들었는데 많아	0
이별 일주일 후 ! 우리의 이야기.	이별 통보 후 일주일이네	1
썸남이 약속 자꾸 미루는데 내가 싫은걸까?	썸남이 약속 자꾸 미루는데	0
매주 수요일 그를 만날 수 있어.	매주 수요일 그 사람을 만날 수 있어.	0
너무 덥다	더워 헥헥	0
어제 짝남이랑 놀았는데 꿈같다.	어제 짝남이랑 놀았는데 꿈같다.	0
친구랑 술 한잔 기울이고 들어왔습니다.	카톡사진을 보니 눈물이 나네	1
고구마만 먹고 다이어트 해야지	고구마 다이어트 해야지	0
짝녀의 전 남친이 나탔났음.	짝녀의 전 남친이 나탔났음.	0
소개팅으로 잘된 사람도 있나?	소개팅으로 잘되기도 하나?	0
이별 6개월째네	이별 극복할수있을까?	1
홧김에 짝남한테 고백했다.	홧김에 고백했다.	0
답 좀 줘	답답한 마음	1
단순하다.	너무 단순한 것만 하는거 아니니.	0
코골이 너무 시끄러워	코골이 어떻게 고쳐?	0
여자들은 좋아하는 남자가 자기보다 능력이 좋은 경우에만 좋아하나요?	여자들은 능력이 좋은 경우에만 좋아하나요?	0
손목 아프다구	손목 아파	0
오락가락하네	오면 안돼? 예전처럼	1
이렇게 얘기라도 하면 나아질까?.	이번주 일요일날 만나기로 했어	1
말이 안 예쁘게 나와	말이 예쁘게 안나와	0
스트레스성 위통이	슬픈 이별.	1
출산휴가 있는 회사로 이직할까?	출산휴가 있는 회사로 이직할까?	0
출근이 스트레스야	출근 자체가 스트레스야	0
잊기가 힘듭니다.	잊어야 살 수 있을 것 같아	1
찌질하게 게임카톡보내는거 욕하고 싶어	차라리 널 만나지 않았더라면	1
제발 잠좀 자게해주라	젠장	1
코감기로 찡찡거려	감기 들 거 같애	0
수학여행때 뭐 입지?	수학여행때 뭐 입지?	0
이 길이 나에게 맞는걸까	이 길이 맞을까?	0
계속 도전하는 거 귀찮아	도전하기 싫다	0
난 잘못이 없다	날씨가 제 마음같네.	1
마지막 현관문을 닫을 때가 안 잊혀	마지막으로 편지까지 썼는데	1
내일 발표 준비 아자아자	내일 발표 준비하고 있어	0
아직 노후 준비는 이르지?	노후 걱정할 나이는 아닌데	0
솔직히 말하면 헤어지고 싶어	술 먹으니 연락하고싶어지네	1
뭐 하는 중?	뭐 해?	0
잠 와	잠 온다	0
남자친구랑 카페가면 무슨 얘기하지?	남자친구의 유머코드가 너무 안 맞아.	1
짝남한테 정 떼는 방법 없나.	짝남한테 정 떼는 방법 없나.	0
착하다고 오히려 무시하는 것 같아	착한 사람을 괴롭히는 세상	0
구박하면서 엄청 일 시켜	일도 못하는데 엄청 시켜	0
까아 오빠들 컴백한다	내가 좋아하는 가수 컴백한다	0
헤어지고 환승한 그녀	환승이별 당했습니다	0
이별후 한달.	이사람 무슨 생각인걸까	1
광고가 안끝나	요즘 광고가 너무 길어	0
엄마 미안해	엄마한테 미안해	0
여자친구가 클럽에서 춤만 춘다는데 진짜일까?	여자친구가 클럽에서 춤만 춘다는데 진짜일까?	0
별의별 사람이 다 있는 듯	진짜 별 사람이 다 있어	0
다정한 사람 만나고싶어	데이트 장소가 항상 고민이야	1
학회 가는 중	학회 가고 있어	0
마무리	마음 정리중	1
집에 아무도 없어	나 홀로 집에 보고 있어	1
나 뚱뚱한데 좋아하는 남자에게 연락해도 될까?	나 상사병 걸렸나봐	1
소개팅 해주고 욕먹음	친구한테 소개해주고 욕만 먹었어	0
지금 나오라고 하면 나올까?	지금 나오라고 하는거 예의 없음?	0
보고싶다, 목소리라도 듣고싶어	보고 싶어 전 남자친구가 너무	0
상처가 역시 크네	상처를 받는다는건 	0
윗집 애 또 뛴다	층간소음 심해	0
다이어트 효과 있는 것 같아	살 좀 빠지는 것 같아	0
몸에서 받아주는건 담배밖에 없네	못되져야 하나봐 너무 힘들어	1
반 정도는 정리가 된 것 같아	밤마다 미치겠어	1
짝녀 생각할수록 정리 되는 느낌.	짝녀 생각할수록 정리 되는 느낌.	0
계속 시간을 갖자는 의미는 뭔가?	고작 그러려고 날 떠난건지	1
술 먹을 때 옆에서 챙겨줬는데 썸임?	이별 이야기 하나	1
선톡을 안 해	선톡을 하면 안 돼나	0
방학이 필요해	방학이 있었으면 좋겠어	0
정장 한 벌 맞췄어	정장 맞췄어	0
보이스피싱 같아	보이스피싱인듯	0
연락 문제로 싸웠는데 어쩌지?	연락해보까?	1
죄송해 너무답답해서 여기에올려봐	주저리 주저리하게 돼	1
가족들이랑 여행 갈거야	가족여행 가려고	0
벌써 한달이 되었다	별똥별 떨어지는 날	1
승부욕 있는 남자가 좋아	승부욕 있는 남자가 좋아	0
우리 남편 또 늦게 들어와	남편이 맨날 늦게 들어와	0
짝녀 알바 그만둬서 못나는데 연락처 물어보면 싫어할까.	짝녀 알바 그만둬서 못나는데 연락처 물어보면 싫어할까.	0
밤만 되면	밤이 되니깐 감수성 터짐	1
주차하다 긁었네 내돈	주차하다 긁었어	0
참 소박하고 순수했던 사람.	참 허무하네.	1
씻고 자야 되는데 졸려.	씻고 자야지되는데 너무 피곤해.	0
내가 좋아하는걸 그사람이 알았으면 좋겠어.	내가 좋아하는걸 그사람이 알았으면 좋겠어.	0
목돈 만들기	돈 굴리기	0
옥상에 뭐 좀 심어볼까	베란다에 뭐 심어볼까	1
바라는게 없어	그냥 이렇게 살고 싶어	0
사랑하는데 너무 계산적인 여자친구가 고민이야.	사랑하지만 여자친구가 너무 계산적이야.	0
어떤 놈인지 확인하고 싶으면 이상한가	어떻게 살아가야 할까	1
사랑에 빠진 거 같아	사랑하는 거 같아	0
연애할때 몇살 차이가 적당해?	연애할때 몇살 차이가 적당해?	0
정말 좋았음!	날씨 좋다	0
너 만든 사람은 누구야?	남동생한테 자꾸 화내게 되네	1
남자들은 좋아하는 사람한테만 잘해주고 그래요?	남자친구 소개시키는 자리 내가 더 떨려	1
그사람 봤어	모든 진실을 알게 됐네	1
어제 짝남이랑 꿈에서 놀았는데 다시 꾸고 싶다.	어제 짝남이랑 꿈에서 놀았는데 다시 꾸고 싶다.	0
마음도 춥고 날씨도 춥고	마음을 억지로 접는게 어렵네	1
여자친구가 자꾸 의심해	여자친구가 의심해	0
스트레칭 해야되는데	스트레칭해야지	0
독서 좀 해야겠어	책 좀 읽어야지	0
키 작은 남자 좋아하는 여자 있나요?	키 작은 남자 좋아하는 여자 있나요?	0
언제 다 고쳐	잘못 쓴 거 엄청 많아	0
짝녀가 나한테 관심이 전혀 없는 듯.	짝녀가 나한테 관심이 전혀 없는 듯.	0
우리 반에 좋아하는 여자애가 생김.	우리 반에 좋아하는 여자애가 생김.	0
첫사랑인 거 같아	첫사랑인 거 같아	0
안 잊혀져.	마지막으로 한 마디 하고 싶었어	1
빵꾸난 양말 봤나	양말에 빵꾸난 거 봤나	0
어제와 오늘 문득문득 생각에 눈물을 흘립니다.	어젯밤에 헤어진 여자친구 집에 찾아 갔다 왔어.	1
재채기 나올거 같은데 안 나와	재채기 나와	0
사랑이라는 감정 참 우습네	사무실에 나왔지만 손에 안 잡히네	1
복전하면 힘들텐데 그래도 하는게 나을아?	복전하면 좋아?	0
괜찮은 줄 알았는데 남자가 생겼단 말에 마음이 또 다시 덜컥 내려 앉네	괜찮은주 알았는데	1
요즘 대학가에 낭만이 사라진 것 같아	대학에도 낭만이 없어	0
좋아하는 사람이랑 종교가 다른데 괜찮을까?	좋아하는 사람이랑 종교가 다른데 괜찮을까?	0
남자들 직장 내에서 좋아하는 여자 있으면 어떻게 해?	남자들이 좋아하는 여자들 특징은 뭐야?	1
와플 기계사서 집에서 만들어 먹고 싶다	와플 기계 사고 싶다	0
얼마나 더 지나야 아물런지	에궁	1
여친이 나랑 찍은 사진 프사로 안해.	프사 바꾸는 거 귀찮아서 잘 안해.	1
사진을 지웠어	살아간다	1
나 같이 향기로 좋아하게 되는 사람도 있나?	나 사랑하긴 했니?	1
자기를 3인칭으로 말하는 여자친구의 말투가 고민임.	여자친구의 말투가 고민임.	0
사귄지 얼마 안됐는데 스킨십하려고해	사귄지 얼마 안됐는데 스킨십하려고해	0
아놔 화장하고 예쁘게 하고 다니고 싶다.	나도 화장 잘 하고 싶다	0
자꾸 끌려 어떻게 해	이상하게 끌리는데 말 걸어볼까	0
이런 내가 너무 싫어	이런게 연애니??	1
나쁜 건지 어색해서 그러는 건지 모르겠어	나쁜 건지아닌지 모르겠다	0
이별 넋두리	이별 상태.	1
참다 참다 결국 마지막으로 문자보냈어	처음 느끼는 감정	1
자전거  타고 여행하고 싶다.	자전거 타다 넘어졌어	1
헤어지고 나서 많은 일들이 있었네.	헤어지고 벌써 한달이 됐네.	1
새 남자가 생겼나봐	새 여친이 생겼더라구	1
옷은 많은데 입을 게 없어	입을 거 없다	0
친구 결혼식에서 축가 준비 중	친구 결혼식에서 축가 불러 주기로 했어	0
연락을 너무 안 해	너무 바빠서 잘 못 만나	1
비 맞아서 옷 젖었어	옷이 다 젖었어	0
친구가 밥산다고 해서 나갈라구	친구가 밥값낸다고 해서 나가	0
사귀는 사이인데 '야'라고 해. 기분 나쁜데 어떡해?	친하다고 '야'라고 하면 기분 나뻐	0
뭘하면 행복할까?	행복하기 위해 중요한 게 뭐야?	0
먹으면 살 찔까봐 걱정돼	맛있는 거 먹고 싶은데 살 찔까봐 걱정돼	0
핸드폰 떨어 뜨렸어	폰 떨궜어	0
제가 먼저 파혼 하자고 매달리고 있습니다	제가너무집착했어	1
잊겠다 다짐했는데 아직 멀었나 봅니다	잊기 싫은데 잊혀져만 가.	1
여자들이 좋아하는 남자 말투는 뭐가 있나요.	여자들이 좋아하는 남자 말투 있나?	0
썸은 좋았는데 연애는 별로	썸까지 좋았는데 연애 상대로는 별로	0
내가 좋아하는 사람보다 나를 좋아해주는 사람 만나는게 행복한거라더니.	내가 좋아하는 사람보다 나를 좋아해주는 사람 만나는게 행복한거라더니.	0
호텔에서 소개팅하기로했어	호텔 로비에서 소개팅하기로했어	0
헤어진 사람과 같이 갔던 콘서트 영상이 티비에 나왔어	헤어진 여자친구 연락	1
왜 이렇게 가슴이 먹먹하냐	오늘따라 우울하고 답답해	0
계속 방학이면 좋을텐데	방학 안 끝났으면 좋겠다	0
기념일 못챙겼어	기념일 또 까먹었어	0
짧은만남 긴여운	쭉 괜찮다가 오늘 갑자기 너무 보고싶고 생각나네ㅠㅠ	1
대리 불렀는데 안 오네	대리운전 불렀어	0
차 팔았더니 불편하네	차 팔아서 불편해	0
남자가 먼저 고백해야 해?	남자가 먼저 고백해야 하는걸까? 그냥 기다려?	0
인형 좋아할까?	인형 사줄까	0
직장에서 따돌림 당함	직장에서 왕따 당하고 있어	0
동거하는데 헤어져야할 거 같아	동거하는데 이제 헤어져야할 거 같아	0
산넘어 산이네.	삼다리 여친	1
짝남 잊으려고 하는데 인스타에서 자꾸 보여요.	짝남 잊으려고 하는데 인스타에서 자꾸 보여요.	0
비가 오니까 짝사랑 하는 사람 더 생각나.	비가 오는 날 사랑 하는 사람 더 생각나.	0
오늘 짝남이 썸녀 생긴거 알게 돼서 술 좀 마셨어요.	오늘 짝남이 썸녀 생긴거 알게 돼서 술 좀 마셨어요.	0
결혼은 하고 싶은데 며느리는 되기 싫어	결혼이야기를 꺼내고 싶은데 어느 분위기에 꺼내는게 좋을까?	1
결혼하면좋을까	결혼하면 좋은 점 말해줘	0
업데이트가 너무 오래 걸려	업데이트가 엄청 느려	0
일과시간 후 집에 도착한 다음에도 궁상	일전에 여기서 댓글주고 받던분들.	1
돈없이 결혼하기 가능?	맨몸으로 결혼하기 가능?	0
사업 구상	사업 구상하고 있어	0
동물 좋아하는 사람 어때?	동물 좋아하는 사람 어때?	0
싸울 때 내가 아는 사람이 맞나 싶어	싸울 때 그 사람이 맞나 싶어	0
새해다!	새해 복 많이 받아!	0
오 좀 멋있는데	너무 멋있다	0
짝남 어떻게 해보지도 못하고 그냥 연락 끊긴지 오래됐는데 연락하는 거 오바야?	짝남 어떻게 해보지도 못하고 그냥 연락 끊긴지 오래됐는데 연락하는 거 오바야?	0
또 다시 이별을 맞았네	또 연락을 해버렸네.	1
연상이 좋아	밥 잘 사주는 예쁜 누나 어디 없나	0
별 일 없었어?	너는 아무일도 없었나봐?	0
장거리연애 이별	재회 네달 만에 다시 헤어집니다.	1
하품이 저절로 나오네	하품 나와	0
끝인거 답은 아는데 왜 안되는걸까?	나 심리상담 받고 왔어	1
나 비호감인가 왠지 나를 싫어하는 것 같애.	그 사람은 나를 싫어하는 것 같애.	0
이별인지	몇일동안 고민하다가 찾아갔습니다.	1
나한테 냄새 날까?	나한테 이상한 냄새 나나?	0
제대로 사랑하고싶어	사랑하고싶어	0
시골 내려가서 살까	시골에서 사는 거 어떨까?	0
썸 타는 사람 선물 뭐 사야 해?	썸 타는 사람 생일이야. 선물 사야 해?	1
필기구 안가져 왔다.	필통 두고 옴	0
아무리 눈치 없어도 좋아하는 티 내면 알아채나요?	눈치 없는 편인데 좋아하는 티 내면 알아채나요?	0
짝사랑이었네요.	나만 좋아한 거였네.	0
월급에 비해 근무시간이 너무 긴 거 같애	연봉대비 근무시간이 너무 긴 거 같애	0
첫사랑 다시 만나도 사랑할 수 있을까?	첫사랑 다시 만나도 사랑할 수 있을까?	0
사랑하는 사람과 함께 있고 싶어	사랑하는 사람과 함께 있고 싶은 거 당연한거 아니야?	0
나에게만 집중했으면 좋겠어	나한테 관심 있는게 맞을까?	1
이별은 역시나 힘드네.	이별을 극복한건지.	1
봄이 왔어	드디어 봄이다	0
남자친구와 방구 언제 텄는지?	남자친구한테 안 설레	1
두번 이별하는 느낌입니다 하	둘만의 기념일 너무 힘드네	1
남자친구랑 왜 맨날 싸울까?	남자친구의 스킨쉽이 너무 부담돼.	1
열받아 아오	거의 매일 술	1
얼어 죽는 줄	얼어죽는 줄 알았어	0
여자친구가 키가 너무 커	여자친구가 키가 커	0
나는 받기만 하는 것 같아	나랑 맨날 엮이는 사람이 있는데 좋아졌어.	1
짝남이랑 사귀기로 했어	짝남이 헤어진지 별로 안됐는데 다가가도 될까?	1
속이 영 안 좋아	속이 안 좋아	0
연락 문제로 애인이랑 싸운 적 있어?	연락하고 싶어	1
전화 못하겠어	전화하는 거 힘들다	0
다시 한번 또.	다시는 연락 안하고 잊어볼려구	1
보고싶어 잠이 안와	보고프다	0
너무 잘해줘서 이래도 되나 싶어	나한테 너무 잘해줘서 이래도 되나 싶어	0
사랑이 뭘까?	사랑이 뭐냐고	0
잠 못자고 있네	한참 뒤척거리다 잠들어	0
첫사랑이렇게 힘드네	초코렛이나 꺼내 먹어야지	1
여자친구 스타일이 마음에 안들어.	여자친구 스타일 바꿔 주고 싶어.	0
자존감이 바닥을 친다	자존감이 너무 떨어졌어	0
뭐 보고 결혼 결심해?	보통 뭐 보고 결혼 결심해?	0
뜨겁게 사랑하거나, 쿨하게 헤어지거나	로맨스는 없습니다	1
여친이 아는 형이랑 썸 타는데	아는 형이랑 여수 갔다옴	1
헬스장 사람들 몸이 좋아	헬스장에 사람들이 몸이 다 좋아	0
항상 나중에 후회해	항상 뒤늦게 후회해	0
배에서 꾸룩꾸룩 소리 남	배에서 소리 남	0
생각 외로 늠나 재미났다	아이들은 아이들 다운게 좋은 거 같아	1
걔 너무 싫다	스트레스 주는 사람이 있어	0
일만 하고 살았는데 이 모양	지금까지 일만 하고 산 거 같애	0
뭘 해야 할지 모르겠어	오늘 선생님께 칭찬받음	0
먼저 연락이 자주 오면 썸인가요	별거 아닌걸로 연락하는데 썸인가요	0
오늘밤 하고픈 말 다쏟아내려합니다!	오늘은 노래한 곡에 또 울컥 ㅠ	1
스트레스~	아 스트레스 받아	0
나를 사랑했던 건 진심이였을까?	나만 아직 그자리인거 같아	1
돈 좀 빌려줘 	용돈 줘	0
이제 너 따위 생각도 안난다 꺼져	이제 때론 괜찮기도 해	1
좋긴 한데 귀찮아	만나면 좋긴 한데 귀찮아	0
감기가 걸릴 거 같아	감기가 오려나	0
헤어지고 3개월만에 만나고 왔어	헤어지고 난 후 나의 일상들.	1
썸남 생겼는데 너무 조급해.	썸남 생겼는데 맘이 급해져.	0
짝남이 연락왔어 어떡함.	나만 좋아하는 줄 알았는데 전화 왔어 어떻게 해	0
겨울이 가고 봄이 올거야	겨울 지나 봄이야	0
했어야 했는데 하지 못한 것들 때문에 후회돼	눈물 남	1
소식이 궁금해~	솔로 7개월 넘어가네	1
대체 뭘해야 머릿속에서 지울수 있을까?	덜 좋아하는 방법만 알면 힘들지 않을텐데	1
바람 불어 좋은 날.	바보같은 짓을 했어.	1
사귄지 한달됐어	사귄지 한달됐어	0
5년연애 끝은 정말 멍하고 허무하네.	5년이란 시간이 무색해지네	0
청첩장 만들어야지	청첩장 만들어야지	0
자기 소개 또 어떻게 해	자기 소개 어떻게 해	0
나를 좋아하는 사람도 있을까?	나를 좋아하는 사람은 아무도 없을거야.	0
좋아하는 사람이 너무 잘생겼어	좋아하는 사람이 너무 잘생겼어	0
희망고문	힘드네 포기라는게	1
왜 이렇게 쓸쓸하지	외로워	0
기부 좀 했어요	기부했어	0
헤어지고 차단하는 이유는 뭘까?	헤어지고나서 여자가 연락이 없다는건	1
남자친구 영장 나왔대	영장 나왔는데 여친에게 어떻게 말하지	1
술 마시고 망가질테닷	술 많이 마셔야지	0
안녕안녕	안녕하세요	0
좋아하는 사람 생겼는데 페북 친구 신청 해도 될까요?	좋아하는 사람 생겼는데 페친 신청 할까?	0
딱 알아봤는데	떠나간 사람 생각하면 끝도 없습니다.	1
사랑을 알게 해준 너	사랑을 알게 해준 너 고마워	0
헤어진지 3주가 아직안됐네	헤어진지 4일	1
화장 열심히 했는데	화장 무너짐	0
주말인데 연락이 안 와.	주말인데 연락이 안 와.	0
술 마시러 가고 싶다	술 마시고 싶다	0
우리모두 마음의여유를 가져봐	우울하고 무기력해	1
연락 하지 말라고	연락 좀 안 왔으면 좋겠어	0
머리 또 잘라야 돼	머리가 너무 빨리 자라	0
붙잡으려고	비가오네	1
자기 말은 기억 못하고 나만 혼내는 사람 어떡해?	자기가 한 말 기억 못해서 나만 혼내는 사람 어떡해?	0
목적 있는 만남이라는 걸 알게 됐어	목적 있는 만남이었구나	0
비트코인 날림	비트코인 ㅜㅜ	0
친구들이 짝녀를 별로라고 하네요.	친구들이 짝남 별로라고 하는게 짜증나.	0
할 수 있는 일이 이것뿐이라서	해외장거리 헤어진지 3주 다되가네	1
오랫동안 썸만 타고 솔로인건 왜그래?	오랫동안 썸만 타. 뭐가 문제임?	0
내가 좋아하는 사람이 다른 사람을 짝사랑 해. 도와줘야 할까.	내가 좋아하는 사람이 다른 사람을 좋아하는데 도와 줄까. 	0
썸 너무 들이댔나	내가 너무 들이댔나	0
짝남이 공무원준비를 한다는데 고백하면 방해가 될까?	짝남이 공무원준비를 한다는데 고백하면 방해가 될까?	0
알바 같이 하는 사람 좋아	알바하는데 같이 일하는 사람 좋아져	0
여자들이 좋아하는 남자 특징?	여자들이 좋아하는 남자 특징?	0
내 사랑이 부족한걸까?	내가 더 좋아하는 관계	1
연애상담하더니 둘이 사귀더라	둘이 사귀더라	0
당구 쳤어	당구 치고 옴	0
짝남이 있는데 나는 사정이 안돼. 연애를 안하는게 맞는걸까?	짝남이 있는데 나는 사정이 안돼. 연애를 안하는게 맞는걸까?	0
짝사랑 중일 때 장점.	짝사랑 중일 때 장점.	0
사랑하는데 외로워	사랑하는 사람 있는데 외로워	0
남친이 입이 험해	남자친구가 입이 험해	0
여자친구가 혼자 여행 간데	여친이 혼자 여행 가겠데	0
외로움을 이겨내는 법 좀	요즘 너무 고민이네	1
이별 후 어떻게 될까	이별 후 후회, 아쉬움	1
결혼전제로 만나고 있어	결혼할 사이로 사귀는 사람 있어	0
다들 아니라는 남자.	다들 잘 헤어졌데	1
스팸 갑자기 왜케 많이 와	스팸 메일 갑자기 많이 와	0
다시 헤어졌습니다.	다음주가 너무 무서워	1
썸남이 넘 좋아서 절제가 안돼.	썸남이 넘 좋아.	0
짝녀한테 라인 왔는데 뭐라고 답장 해야할지 모르겠어.	짝녀한테 라인 왔는데 뭐라고 답장 해야할지 모르겠어.	0
수업시간 내내 잤어	학교에서 계속 잤어	0
남편이랑 놀러 가고 싶다.	내 친구랑 내 짝남이 서로 좋아하는 것 같아.	1
해외 여행 너무너무 가고 싶다	해외여행 가고싶다	0
이제 진짜 안녕!!	이제 확실히 알겠어	1
왜 연락 안 하지	마음에 드는 거 같은데 고백을 왜 안 하지	0
짝남이 날 신경쓰는 것 같은 건 내 착각일까.	짝남이 날 신경쓰는 것 같은 건 내 착각일까.	0
만나면 좋은 사람이 있어. 헤헤	친구랑 만나면 좋아	0
기본이 뭔지도 모르는 것 같아.	기본이 안 되어 있어	0
비 와	비 오는데?	0
생각이 자꾸 나	자꾸 생각나	0
이별 통보 받은지 7일째	이별 한달반째	1
오늘 화장 안하고 집앞 나갔는데 그 사람 만났어	메이크업 안했는데 우연히 만났어	0
추석 잘보내세용	다른 사람들에 비해 만남은 짧앗지만	1
나는 못난거 같은데 인기있는 여자에게 연락해도 될까?	나도 좋아하는 사람이랑 영화 보고 싶다.	1
결혼식 사회 봐주기로 했는데 신부 친구들 다 예쁜듯	신부 친구들이 너문 예뻐서 결혼식 사회 봐 주기로 했어	0
짝녀가 어떻게 하면 내 생각을 하게 할까?	짝녀가 어떻게 하면 내 생각을 하게 할까?	0
자꾸 걱정이 되는데 연락할까	취업 때문에 걱정돼	1
재회 생각 완전히 접었습니다.	재회를 기다리다 단념하게된 이유가 뭐였나?	1
짝남이랑 조금이라도 닮은 사람 있음 눈길 간다.	짝남이랑 조금이라도 닮은 사람 있음 눈길 간다.	0
남자친구 오지랖 너무 많아서 속상해	남친 때문에 속상해	0
여보세요.	누구냐 넌?	1
내가 좋아하는 사람이 누군지 점점 헷갈려.	내가 좋아하는 사람이 누군지 점점 헷갈려.	0
싸운다의 기준이 뭘까?	사랑한다는 기준이 뭘까	1
잘못이라면 더 많이 좋아했던 죄.	잘참다가 페북을 봐버렸네	1
단 하루도 널 사랑하지 않은 날이 없었어	데이트 통장 만들까?	1
얼굴 보니까 떨리더라	오랜만에 보니까 떨리더라	0
좋아하는 사람 직업이 좀 걸리는데 계속 좋아해도 될까요?	좋아하는 사람만 보면 눈물이 나는데 어떡해?	1
적극적인 여자가 좋아	적극적인 여자가 좋아	0
두달전에 잠수이별했던 전남친이 연락한다	두번째 이별	1
여유가 너무 없어	마음의 여유가 없어	0
독학하려니까 힘들어	학원 안 다니고 독학하는데 힘들어	0
아놔 코 막혀	코 막혀	0
한순간에, 무너진 느낌이었습니다	한잔 했습니다	1
커뮤니티 하는 썸녀 어때?	커뮤니티 하는 썸녀 어때?	0
잘 살고 싶어	성공하면 좋겠다.	0
이 쓰레기야	너 진짜 쓰레기야	0
보여주고싶은데 보여주지 못하니	봐야하나 , 보지 말아야 하나.	1
좋아하는 여자애한테 손편지 줘도 돼?	좋아하는 여자애한테 손편지 줘도 돼?	0
미련스럽다	미련한 여자의 기나긴 이별 이야기	1
학교 다닐 때 공부 좀 할걸	어렸을때 공부할껄	0
오늘 치마랑 바지 뭐 입지?	바지 입을까? 치마 입을까?	0
비싼 선물 부담스럽나.	명품 선물 부담스러울까	0
장학금 가능할까?	장학금 받을 수 있을까?	0
집에 친구 오라고 하려고	집에 친구 초대하려고	0
드디어 커플 반지 받았어	반지 받았어	0
한 달 동안 잊으려고 노력해보라네	한달 사귀고 헤어진 남자 무슨 생각일까?	1
짝녀가 좋아하는 사람이 있답니다.	짝녀가 좋아하는 사람이 있답니다.	0
누가 봐도 썸 타는 사이인데 연락이 없어.	누가 봐도 썸 타는 사이인데 연락이 없어.	0
2주전에 헤어졌습니다	3개월만에 연락이 왔습니다	1
안친한데 연락해도 될까?	건너건너 아는 사람인데 연락해도 될까?	0
영화볼때 너무 목소리가 큰 남자친구가 고민	영화볼때 너무 목소리가 큰 남자친구가 고민	0
돈이 엄떠	돈 어디갔지	0
어떻게 하면 좋을까?	내마음을 모르겠어.	1
사수님 너무 좋아	사수 좋아하는 거 같애	0
누락된걸까	나 누락됐나봐	0
긴시간이 흐른 후면 괜찮아지겠지	깨달음은 늘 늦게 온다	1
생강차 끓여 먹어야겠다	생강차 먹어야겠다	0
안경 말고 렌즈 껴야겠어	안경 바꿔야지	0
좋아하는 여자에게 어떻게 연락할까?	좋아하는 여자에게 어떻게 연락할까?	0
학원 안가고 싶다.	학원 가기 싫어	0
휴대폰 바꿀 타이밍	핸드폰 바꿀 때가 된듯	0
양심이 콕콕	양심에 찔려	0
썸 타고 있는데 연락 끊겼어. 먼저 해도 돼?	썸남이 연락 안하는데 먼저 해도 돼?	0
생각이 불순해져	생각이 불순	0
함께 해서 행복했다.	그 사람이랑 같이 있기만 해도 행복해	1
좋은남자 만나서 행복하게 살아라.	견디세 그저 견디는 수밖에 없어 ㅠ	1
새벽되니까 감성적으로 되네	술 너무 많이 먹었어.	1
썸타는거 친구한테 이야기 한고 싶다.	아 꿈에서 맨날 나와	1
보고싶어	보고파	0
웨딩드레스를 입은 너를 보고	웨딩드레스를 입은 너를 보고	0
좋아하는 사람이 있는데 사연이 길어요.	사연이 길어요.	0
그녀의 소식	그노무 카톡.	1
기다리면 연락은 오더라구	기분이 너덜너덜	1
핸드폰 떨어뜨려서 고장 났나봐	썸타는거 친구한테 이야기 한고 싶다.	1
인형뽑기 아직도 하나	인형뽑기는 유행 지났지?	0
노래방 노잼	노래 못해서 노래방 안 가	0
나 머리가 나뿐 것 같아	나 머리 나쁜 듯	0
맨날 똑같애	항상 똑같애	0
농활 간다	농촌 봉사활동 간다	0
내 생각대로 살거야	남이 걷지 않는 길을 가려고 해	0
프로젝트 끝났으면 좋겠다	프로젝트 빨리 끝났으면 좋겠다	0
이 오빠 나를 좋아하는 건가.	이 오빠 나를 좋아하는 건가.	0
내가 너의 곁에 잠시 살았다는걸	내가 사랑했던 사람	1
보드게임 처음해 보는데 재미있아.	보드게임 재밌다	0
추워 죽을 뻔했네	추워죽겠다	0
잊을 수 있을 줄 알았는데 못잊겠습니다.	지 맘대로 연락 왔는데 끝냈어	1
키가 하나도 안 컸어.	키 크는게 멈춘 것 같아.	0
이 여자애의 행동 나를 좋아하는게 맞나?	나를 좋아하는게 맞나?	0
괜찮은 사람인데 사귀긴 싫어	만나면 좋은데 사귀긴 싫어	0
화이트데이에 고백할까요?	화이트데이인데 고백할까?	0
목 아파	목이 뻐근해	0
마음이 너무 아파	마음이 너덜너덜해졌어.	0
한동안 연락 못해서 미안	연락 안해서 미안해	0
짝남이 좋다고 했던 노래 이 새벽에 참 어울리는 노래야.	짝남이 좋아햇던 노래 이 새벽에 참 어울리는 노래야.	0
친구인데 고백해도 될까?	친구인데 고백해도 될까?	0
짝녀가 여친이 되었습니다.	짝녀가 여친이 되었습니다.	0
좋아하는지 확신이 안들어	좋아하는지 확신이 안들어	0
짝남한테 밥 먹자고 그냥 해볼까.	짝남한테 밥 먹자고 그냥 해볼까.	0
스노우보드 배우러 갈거댜	보드 타러 가야지	1
너무 아파 외로워	너무 허무하네	1
기댈 수 있는 남자 만나고 싶어	어깨를 기댈 수 있는 남자 만나고 싶어	0
괜찮은게 아닌가봐	괴로워	0
웃을 때 진짜 예뻐	웃을 때 진짜 예뻐	0
어떻게 나한테 이러지	어떻게 해야 여자친구가 제 진심을 알아줄까	1
사랑은 죄가 아닌데	내가 잘못한거 아닌데	1
갑자기 차가워졌는데.	같은 반인데 헤어지자고 해야 하나??	1
장난인지 진심인지 구분이 안돼.	장난인지 진심인지 구분이 안돼.	0
고백할 타이밍인 거 같아	고백 타이밍인데	0
점심 메뉴 좀 골라줘	점심 메뉴 고르는 거 힘드네	0
보이스피싱 같은데	나 보이스피싱 당한 거 같은데 어떡해?	0
이별이 다시 올거 같은 느낌	이별이 코 앞으로 다가온것 같아	1
고민 있어	고민 좀 들어줄래	0
서로 나쁘게 헤어지지 않고 싶은데	성격이 좋은 건지.	1
주말에 놀꺼 추천	주말에 뭐 하고 놀까?	0
몸이 아프니까	못잊을땐잊고싶고잊혀지려하니잊기싫은것	1
짝녀가 단톡에선 답장하고 갠톡은 답장 안해.	짝녀가 단톡에선 답장하고 갠톡은 답장 안해.	0
더운 여름에는 냉면만한게 없는 듯	뭐니뭐니 핻고 여름에는 냉면이지	0
엄마가 동생한테만 잘해줘.	엄마가 동생이랑 차별해	0
연애 갱년긴가	연애 위기인 거 같아	0
연애 초보다 연락을 너무 안해	연애는 진짜 좋아하는 사람이랑 해야해.	1
더워서 시원한 냉면 먹고 싶어	여름이니까 냉면 땡긴다	0
고백한 애가 톡이 안와.	고백했는데 답이 안 와	0
좋아하는데 걸린 시간이 보통 어떻게 돼요?	좋아하는데 걸린 시간이 보통 어떻게 돼요?	0
잘못된 만남이였을까?	눈물이 나네	1
면도기랑 이것저것 사야되는데	면도기 사야되는데	0
밥이나 먹자	밥먹자.	0
내가 첫 연애 상대라고 하는데 거짓말 같아	내가 그 사람 첫사랑이래	0
헤어진 연인의 새로운 사랑	헤어진 후 이런 생각하면 안되지만. 계속 부정적인 생각만 드네.	1
청소 해도 티가 안나	청소 해도 해도 더러워	0
이 행동이 절대 용납이 안돼나.?	이것도 제 미련이겠죠?	1
전남친이 자꾸 생각나	전남친 보고 싶어	0
그는 조금이라도 내 생각을 할까?	조금이라도 내 생각을 할까?	0
사랑하는 사람이 없어.	운명적인 사랑이 있을까	1
바보같이 연락했는데 읽씹당했어	반가운 연락	1
얼른 아아야 할텐데	건강 빨리 회복해야지	0
짝남 때문에 마음이 아픈데 어떻게 해야할지 모르겠어.	짝남 때문에 마음이 아픈데 어떻게 해야할지 모르겠어.	0
연락 어떻게 시작함	연락 처음에 어떻게 시작함	0
앞머리 내릴까봐	앞머리 내릴까봐	0
난 왜 이모양일까	나는 모자란 사람인 거 같아	0
여자친구가 왜 저랑 헤어졌는지 아직도 모르겠어	여자친구의 거짓말	1
남친이 내 친구랑 연락하는 것 같애	남친이랑 내 친구랑 자주 연락하는 것 같애	0
게임 때문에 시간 다갔어	게임하다 시간 다갔어	0
여자친구가 연락이 너무 많아.	여자친구가 연락이 너무 많아.	0
좋아하는 여자애가 유학을 가는데 어떤 선물을 해주는게 추억에 남을까요?	좋아하는 여자애가 유학을 가는데 어떤 선물을 해주는게 추억에 남을까요?	0
자꾸 졸게 되네	자신만만하던게 엊그젠데 이젠 힘들어	1
헤어진지 1달째 됐습니다.	헤어진지 2달.	1
괴롭습니다.	궁금한게 있는데	1
다른 생각을 하는 사람이 많다.	내 생각이랑 다른 사람 생각이 진짜 다르다는 걸 느껴	0
나도 남편이 있었으면	결혼하고 싶은데 사귀는 사람이 없어	0
장거리 연애하면 보통 어느 지점에서 만나?	장거리 연애하면 보통 어느 지점에서 만나?	0
그녀를 잊어야 하는게 너무 힘이 드네.	그녀에게도 후폭풍이 올까??	1
와 진짜 너무 짜증나네	완전히 잊는다는게 쉽지 않네	1
밀당도 아니고 뭔지 맘만 상한다.	밀당하냐고 하는데 속상해	0
여자친구가 잠이 너무 많아.	여자친구가 잠이 너무 많아.	0
썸 탔던 애한테 연락왔어	썸 탔던 애한테 연락왔어	0
폰 베터리가 벌써 없어	폰 베터리가 너무 잘 닳아	0
나랑 있는게 힘들었나봐	혼자가 편하대	0
성형 무서워	성형 해도 될까	0
빼빼로 데이인데 썸남한테 만들어줄까 그냥 살까?	빼빼로 만들어줄까 살까?	0
집에서 먼곳으로 데이트를 자주 가야하는데 꼭 차를 사야할까?	집에서 먼곳으로 데이트를 자주 가야하는데 꼭 차를 사야할까?	0
시간이 너무 안 가 지루해	시간이 안 가	0
눈물만.	눈물이 멈춰지질 않네	0
만나는 중에 이 남자 저 남자랑 연락하는 여자	많은걸 깨달은 이별.	1
나 그대로를 사랑해줄 사람 있나	나 사랑하는 사람 생겼어	1
왜 말을 이해를 못하냐구	왜 말을 못해 말을 못하냐구	0
니가 없는 주말	다 끝났네.	1
그녀를 생각할 수록 내가 비참해져.	그리워수록 내가 비참해져.	0
썸남이 너무 진지해서 부담 돼.	썸남이 너무 진지해서 가끔 부담 돼.	0
사랑한다고 어떻게 표현하지?	사랑하는 마음을 어떻게 표현하지?	0
좋아하는 여자애 생겼는데 떨려 죽겠음.	좋아하는 여자애 생겼는데 떨려 죽겠음.	0
좋아하는 사람 언제까지 기다릴 수 있을까요.	좋아하는 사람 언제까지 기다릴 수 있을까요.	0
여친에게 연락하고 싶은데 어떠하죠?	연락 안되면 내 마음만 타는 듯	1
술먹고 연락오네	술이 왠수지	1
너무 힘드네	너무 힘들다	0
친구가 자꾸 집착하는 것 같은데 뭐라 말하지	친구가 나한테 집착해	0
썸 타는 사람 선물로 향수 어때?	썸 타는 사람 선물로 향수 어때?	0
꿈에서 자꾸 어떤 남자애가 나와	어떤 남자애가 꿈꿔	0
한 여자와 한 남자의 이야기.	한달!! 하고 일주일	1
그를 좋아하면 내가 비참해지는거 아는데도 포기가 안돼.	비참한데 포기가 안돼.	0
남친이 내 사진 프사로 안해.	남친이 내 사진을 프사로 안 바꿔.	0
고데기 했는데 망했어	고데기 망했어	0
짝남이 생겼는데 뭐부터 해야할까.	짝남이 생겼는데 뭐부터 해야할까.	0
핸드폰 꺼질때까지 톡	핸드폰 꺼지기 직전	0
사랑 앞에서 죄인이 돼	사랑이 참 귀엽다.	1
과외비 비싸?	과외비 부담되겠지?	0
무서운 얘기 해줘	나 무서운 영화 보고 왔다	1
4년 사겼는데도 너무 좋아	4년째 연애하고 있어	0
군인입니다 환승이별.	권태기 이기적인 거 알지만	1
진짜 잠 좀 자고 싶네	질긴 인연 드디어 끝인 것 같네	1
헤어지지 열흘짼데 너무 힘드네	헤어진 애인 카톡 안들어간다고 다짐 했는데.	1
재회를 바라는것도 새로운 사랑을 원하는것도 아닌데.	재회했는데 행복하지 않네	1
카톡 상메에 아직도 누구 좋아한다는 티 내는 법 좀.	카톡 상메에 누구 좋아한다고 티 내는 법 좀.	0
이 사람이랑 결혼해도 될까	시어머니가 오라고 하셔	1
썸일 때 다른 사람 만나면	썸일 때 다른 사람 만나면	0
짝남이랑 썸 탈 것 같애.	짝남이랑 같이 도서관 가고 싶어. 방법 좀.	1
또 지각하네	자꾸 지각하네	0
결국엔 끝이라는 생각	결혼 전재 동거가 끝났네	1
썸남의 계속되는 약속 취소.	썸남이 자꾸 약속 취소해.	0
혼자라는건 여전히 많이 힘드네	환경 때문에 헤어진 여자친구	1
짝사랑 하니까 감정 기복 장난 아님.	짝사랑 하니까 감정 기복 장난 아님.	0
위층 소음 괴롭다.	징글징글한 층간소음	0
살쫌 빼고나서 필라테스 해보고싶어	운동해야 하는데 귀찮아	1
썸 타는 거 티내고 싶진 않아.	썸 타는 거 티 안 났으면 좋겠다..	0
사랑하고 싶은데 내가 자꾸 구속해	사랑이라고 구속해	0
나를 정말 사랑하는 걸까?	나를 정말 사랑하는 걸까?	0
다음에 놀러가고 싶어요	가족여행으로 갔는데 증말 천국이였어	1
면도해야 되는데 귀찮아	면도하는 게 낫겠지?	0
내 키 맞춰 봐	내 키가 몇이게?	0
늦었는데도 안 오네	같이 해온 5년	1
짝사랑은 이제 그만할래.	그냥 혼자 설레발 치는 사랑은 그만 할래	0
기다림 속에 갇혀 있어	기다리는 거 지쳐	0
사랑으로 가능한 것?	사랑으로 뭐가 가능해	1
좋아하는 사람 생겼으면 좋겠어.	좋아하는 사람 생겼으면.	0
커플 사진 보니 더 슬퍼	택시비 너무 비싸	1
제발 도와줘	제발 저좀 살려주세요	0
비밀번호 뭐였더라	빌어먹을.	1
짝사랑 했던 여자가 떠나갔네.	짝사랑 했던 여자가 떠나갔네.	0
거래처 직원을 좋아하게 됐는데 어떻게 연락할까.	별로인걸 아는데도 좋아해. 이런 내가 너무 싫어.	1
뇌용량 초과	머리 용량 초과	0
신경이 바늘 끝 같아	자꾸 날카로워진다	0
이직각인가	이직해야할지 고민이야	0
환승이별 당했습니다 ㅎㅎㅎ	환승했다는 소식을 알게되었음	0
이상적인 연애란?	이상적인 연애란?	0
밥 태웠어	밥 탔다	0
결혼 결심한 계기가 있었어?	결혼 결심 이유	0
남자후폭풍	낮에는 그나마 괜찮은데	1
처음 만난 사람한테 연락하는 게 어색해	첨 만났는데 연락하는 게 익숙하지가 않아	0
커피 마시면서 과제 하는 중	카페에서 과제 하고 있어	0
정신 못차리겠다.	정신차리고 싶어	0
걸핏하면 차단하는 놈	견디기가 너무 힘드네	1
혼자 자유 여행 가는 거 괜찮을까	패키지여행이 좋을까 자유여행이 좋을까	0
짤릴 필이 와	나 짤릴 거 같아	0
비밀은 없는 거겠지	비밀은 없어	0
썸 정리하고 싶으면	썸 정리하고 싶어	0
같이 오르고 있는줄 알았는데.	걔 없이 잘지내 보려구	1
썸남 만나기로 했는데 치마? 바지?	썸남 만나기로 했는데 뭐 입지?	0
또다시 꿈에 나왔네.	뜬금 시간을 가지자고 해서	1
수염 기르고 싶다	수염 길러볼까	0
여사친인데 좋아하는 듯.	여사친인데 좋아하는 듯.	0
나도 연애해 보고 싶어	연애하고 싶다.	0
짝남이 다른 여자를 좋아하는 걸 보니 자존감이 떨어져.	짝남이 다른 여자를 좋아하는 걸 보니 자존감이 떨어져.	0
술 고프다	술 땡겨	0
별 사람이 많다	사람은 진짜 다른 가봐	0
이별은 받아들이는 것인가	이별은 받아들인다는 것	0
은퇴가 멀지 않은 것 같아	은퇴하고 뭐하지	1
스키장 알바 하면 재밌을 듯	스키장 알바 재밌대	0
시간이 약이긴 한가봅니다	시도때도없이 생각나네 그녀가	1
주체할수 없는 눈물이 흐르네.	죽을 것 같아	1
언제쯤 이 끈을 놓아야할까. 지금일까.?	언젠가 하는 거죠	1
코코넛오일 먹기 싫어	코코넛오일 맛없어	0
나 미쳐가는 것 같아.	선풍기 틀어도 더워	1
짝남에게 같이 옷보러가자고 해도 될까?	짝남에게 같이 옷보러가자고 해도 될까?	0
이력서 몇 개째 쓰는건지 모르겠다	이력서 광탈 중이야	0
매주 월요일 그를 볼 수 있어.	매주 월요일 그를 만나.	0
프로포즈할때 영상편지도 주려고	프로포즈할때 영상편지도 주려고	0
여자끼린데 썸 타는 경우도 있나	여자끼린데 썸 타는 경우도 있나	0
월급만 나만 그대로야	내 월급만 안 올라	0
퇴사하면 후련할거 같아	퇴사 예정이야 후련하다	0
카톡 뭐라 보낼까?	처음에 카톡 뭐라 보내지	0
잠 들기가 힘드네	잠들기가 어려워	0
만나는 사람마다 유형이 비슷해	내가 만나는 사람은 유형이 비슷해	0
사랑하는 사람이랑 내가 너무 차이나	사랑하는 사람이랑 내가 좀 많이 차이나	0
연애하는 것처럼 결혼 가능해?	연애하고 싶은데 좋아하는 사람이 없어.	1
미친것같아	미친듯이 힘들다.	0
마음이 무거워져	생각만 해도 마음이 무거워	0
많이 좋아하던 전남친이랑 다시 사겨도 될까?	전남친이랑 다시 사겨도 될까?	0
미래를 함께할 반려자인지 확신이 아직 없어	반려자가 맞는지 확신이 없어	0
차 살까	차 사는 게 낫겠지?	0
사랑의 기준은 뭘까	사랑이 익숙해지면 정으로	1
눈물이 뚝 떨어져.	재회를 했는데 다시 헤어짐	1
이별병.	이별예감	1
자장면이 좋아 짬뽕이 좋아	자장면? 짬뽕?	0
어른이 된다는 건 뭘까	어른이 된다는 것	0
이상한나의취미.이별을세는것.	이용만 당했던건가	1
나한테 너무 불만이 많아	시크하고 불만이 많아	0
남자친구랑 너무 좋은데 점 본가에서는 만나지말라해.	본가에서는 만나지 말라해.	0
짝남 잊으려고 나 혼자 나쁘게 생각하는 내 자신이 증오스러워.	짝남 잊으려고 나 혼자 나쁘게 생각하는 내 자신이 증오스러워.	0
이 사람 좋아하는 게 맞을까?	좋아하는 게 맞을까?	0
오늘 하루도 너없이 잘 버텼다	오늘 혼자 영화보고 왔어	1
친한 친군한테 뒤통수 맞음	친한 친군데 호박씨깜	0
상대가 바람펴서 헤어진지 1년이 지났습니다	상처 안받아봤어?	1
버려졌다는느낌	버려진 사람들을 위한 지침	0
피곤해서 못일어나겠어	피곤해서 하루종일 누워있는 중	0
화장도 못하고 전남친 만남	노메이크업인데 전남친 만남	0
기분이 묘해	이 기분은 뭘까	0
여친이 있는데 다른 사람이 좋아지고 있어.	여행 온 김에 짝녀 선물 사려하는데 어떻게 생각함?	1
엄마가 선 보라고 하시는데	부모님이 선 보래	0
헤어진게 잘한걸까	헤어진지 12일째인데.	1
헤어지고 나니 더 소중해	헤어진지 일주일됐습니다.	1
여친 데려다 주고 막차 놓침	데려다 주느라 막차 놓침	0
왜 안되는걸까?	나 심리상담 받고 왔어	1
친구 온대	친구가 지금 놀러온대	0
간통 극복하는 방법	감정에 솔직했을 뿐인데 남자들은 싫은 가봐	1
내 남자로 만들기	내가 너무 기댄 거 같아	1
남자가 낚시를 너무 좋아해	낚시 좋아하는 남자 어때?	0
동성동본으로 헤어질려고 합니다 .	두달이 되가네.	1
다른 사람들은 행복해 보이는데	다른 사람들은 행복할까	0
더 답답한 오늘	계속 답답해	0
친구라도 될 걸 그랬나봐요.	친구라도 될 걸 그랬나봐요.	0
야 너!	양다리? 어장관리?	1
나는 뭘 잘할까	잘하는 게 뭘까	0
얼마나 행복해질려고 이렇게 힘들지	내년에는 더 행복해질려고 이렇게 힘든가봅니다	0
커피 좀 줄여야겠어.	커피 그만 마셔야지	0
문화센터라도 가야겠다.	문화센터 가야지	0
남편이 나보다 집안일 더 잘해	남편이 집안일을 너무 잘해	0
이상하게 자꾸 나만 좋아하는 것 같은 느낌이 들게 해	혼자 좋아하는 이야기.	0
졸업 선물 추천	졸업 선물 뭐가 좋을까	0
스쿼트 하면 무릎에 안좋겠지?	무릎 안 좋으면 스쿼트 하면 안되겠지?	0
여자친구가 담배를 피는게 싫어.	여자친구가 담배를 피는게 싫어.	0
마음이 착잡하다	마음이 복잡해	0
이별 후 젤 힘들 건 허전함인 거 같아	이별.	1
자신감 제로	자신감이 없어	0
썸 타고 있는데 카톡 차단 당함	썸인 줄 알았는데 카톡 차단 당함	1
핸드폰이 넘 느려 어플 좀 지울까	핸드폰 어플 지울까	0
달달한 마카롱 먹고 싶다	마카롱 먹고 싶다	0
살려줘 라는 말이 무심코 튀어 나온다	삼주라는 시간이 흘렀네	1
아직 많이 부족한가	내가 많이 부족한가	0
면도기 새로 사야돼	면도기 또 사야돼	0
나이도 있으니 영양제 좀 챙겨볼까 	영양제 챙겨 먹을 나이가 됐어	0
더우니까 무서운 이야기 듣고싶지	무서운 이야기 해줄까?	0
클럽에서 만난 남자친구와 오래 갈 수 있을까?	클럽에서 만난 남자친구와 오래 갈 수 있을까?	0
덕수궁 돌담길 따라서 둘이 걸었어.	덕수궁 돌담길 걸었어	0
기분이 묘한 하루네	기억이 불쑥 날 때	1
나만의 시간이 필요해	나만의 시간이 필요한 것 같아	0
선물을 주고 싶은데 뭘 주면 좋아할까요?	선물을 뭘 주면 좋아할까	0
창피해	괜히 창피해	0
아직도 잊지 못했던 거니	아침이 젤 힘드네	1
출근하기 싫어	직장 가기 싫어	0
나는 참 단순했다	나랑 만날땐 안바꾸던 프사	1
내가 좋아해도 될까?	내가 좋아하면 안 되는거 아닐까?	0
그만 두고 나오고 싶어	사표 던지고 나오고 싶어	0
플라토닉 연애 어때?	플라토닉 연애 어때?	0
오늘따라 더 힘드네	오늘밤은 비가 내립니다	1
정말 할게 없네.	정말 힘드네. 결혼 앞두고 생각할 시간.	1
남자친구가 말을 예쁘게 해	남자친구가 말 예쁘게 해서 좋아	0
좀 일찍 회사에서 나왔어	조기 퇴근했어	0
집 나가서 혼자 살고 싶다.	자취하고 싶다	0
대기업 취직 어려울까	대기업에 취직하고 싶어	0
썸 탈출하고 싶어.	썸 탈출하고 싶어.	0
첫사랑 보고 싶어	첫사랑 보고 싶어	0
시간이 너무 없다.	생각이 안나	1
가족이 아니지만 가족같은.	갑자기 사랑한다고 이야기해도 될까?	1
너에게 쓴다	너한테 이글 안 보여 줄거다 .	1
나 아직도 애 같아.	나 아직 어른 아닌 거 같아	0
나 맨날 놀리는 애가 있는데 나 좋아하는건가?	나 설레는데 혹시 썸?	1
술 마셨는데 썸 타는 여자한테 전화해도 되는 부분?	이별 뒤.	1
헤어진지 10일째	헤어진지 1년 카톡해도 될까?	1
리치치즈피자 먹고 싶다.	피자 먹고 싶어	0
혼자 영화나 봐야겠다.	혼영해야지	0
여자친구 소개 시켜줬어.	친구를 소개 시켜줬어.	1
점이라도 볼까	점 보러 가볼까?	0
배고파서 자다 깼어	배고파서 일어났어	0
친구로 좋아하는 건지 이성으로 좋아하는 건지 모르겠어요.	친구로 좋아하는 건지 이성으로 좋아하는 건지 모르겠어요.	0
맞춤법 자꾸 틀려서 싫어.	맞춤법 많이 틀리는 사람	0
가슴이 아파	가짜 이별 4개월만에 마침표 찍었습니다.	1
신혼여행 어디로 갈까?	신혼여행 어디로 갈까?	0
길에서 첫사랑 만났어	길에서 우연히 첫사랑 만났어	0
나 자체를 사랑해줄 사람이 있을까	나란 사람을 사랑해줄 사람이 있을까	0
나 문제가 많은거 같아	나한테 문제가 많아	0
남친이 나를 안 좋아하는 것 같은데 내가 붙잡고 있는 것 같아.	남친을 그냥 내가 붙잡고 있는 것 같아.	0
짜증난다!!	짧은 연애였지만 후유증이 기네	1
또 다시 돌아온 불금이네	또 다시 이별입니다.	1
여자친구에게 힘들때 어떻게해?	여자친구가 힘들게 할때 어떻게 잘 말하지?	0
전 여친 카톡 메인 프로필.	전 제가 찬건 줄 알았는데	1
여자가 남자한테 잘해주면 질려?	여자가 남자한테 너무 잘해주면 오히려 질려하나?	0
부모님이 이혼하려는 거 같은데 나는 어떻게 하지?	부모님이 이혼하려는 거 같아.	0
스키 강습 받아야 될까?	스키 처음 타는데 강습 받아야 되나?	0
여자들은 몇 년이고 짝사랑하기도 해?	여자들은 몇 년이고 말안하고 짝사랑하기도 해?	0
이별하고 나니 마음이 찢어 집니다.	헤어지고 너무 예민해졌어	1
썸남한테 같이 카공하자고 할까?	썸남한테 같이 카공하자고 할까?	0
많이 만났는데 아직도 왜 모르지?	그렇게 오래 만났는데 아직도 왜 모르지?	0
사랑이 끝난 것 같아	사랑이 끝났어.	0
좋아하는 남자애한테 답장이 없어. 나 안좋아하는 거 맞지.	좋아하는 마음 들면 고백해야 되는거 아님?	1
치매일까봐 무섭다.	치매이면 어쩌지	0
아침 일찍 일어나 조깅하고 있어	요즘 조깅하고 있어	0
의견 차이가 있을 때 나 너무 무시해	나 너무 무시해	0
오늘 마지막 사진을 정리했습니다	오늘 보기로 했던 그녀, 못 보았네	1
맛있을 줄 알았는데.	뭔가 맛이 이상해	1
비만 판정 받았어	나 비만이야	0
남자는 좋아하는 여자랑 약속 안 까먹겠죠?	남자들은 좋아하는 여자한테 이럴 수 있어?	1
좋아하던 사람하고 멀리 떨어져 있으면 더 보고 싶어져?	좋아하던 사람하고 멀리 떨어져 있으면 더 보고 싶어져?	0
엄마 생각난다	엄마 보고 싶다	0
사회에서도 좋은 사람 많이 만날 수 있을까?	사회에서 좋은 사람 만날 수 있을까?	0
부럽네	분노만 남아	1
생각할 시간을 가지자는 그녀	생일축하했다 바보야	1
모쏠 남자와의 썸	모쏠 남자랑 썸타는 중	0
이사하니까 정리할 게 많아	이사하는 것도 일이다	0
너 미워	너 때문이야	0
짝남이 외국인인데 계속 친한 척하면 부담스러워 할까?	짝남이 외국인인데 계속 친한 척하면 부담스러워 할까?	0
집이 더러워	너무 지저분해	0
머리가 핑핑 도네	맥주 한 캔마시며.	1
썸과 연인 사이	썸과 연인 사이	0
끝이보였던 연애	나 너한테 다시 돌아가면 받아줄꺼야?? 라는 말.	1
처음에는 가벼운 마음이었는데	처음에는 가벼운 마음이었는데	0
모닝콜 해달라고 하는대 좋아하는 걸까?	모닝콜 해달라고 하는대 좋아하는 걸까?	0
으흠	의미 부여 하면 안되겠지만	1
학원폭력 때문에 학교 가기 싫어	학폭 없어졌으면	0
친구들이랑 가기 좋은 곳	친구들이랑 어디 놀러가지	0
사내에서 비밀 연애 하고 있어	비밀연애 하고 있어	0
미칠 것 같아	밑바닥까지 봐서 속은 휴련하네	1
몸무게 좀 줄었으면	미용 몸무게하고 싶다	0
나 뭐 먹고 살지	아무래도 내 체질이 공부는 아닌 것 같아	1
마음을 정리해야 할 것 같아.	맴찢이지만 정리해야지	0
날씨 좀 풀린거 같아	날씨 풀렸다	0
언젠가 자기 복제가 될까	자기 복제가 될까	0
왜 사랑한다고 표현을 안 할까?	왜 사랑한다고 표현을 안 할까?	0
다니던 회사를 그만두고 1년간 여행을 가자고 해.	더 사랑하고 싶다	1
사랑싸움 그만하고 싶어	사랑싸움 힘들다	0
꽃다발 선물 받았어	꽃다발 받았어	0
커플링 맞출까?	커플링 맞춰볼까?	0
아 몰라 자야겠다.	잘래	0
친구들이 사랑하니까 예뻐졌대	친구들이 사랑하니까 예뻐졌대	0
우린 운명인줄 알았는데	우린 운명인줄 알았는데	0
여행 가고 싶은데 시간이 없어.	여행갈 시간도 없다	0
썸타고 있는데 소개팅 나가도 될까요?	썸타고 있는데 소개팅 나가도 될까요?	0
날씨 짱 좋아	오늘 날이 좋아	0
인내	일어나자마자 우울	1
결혼식장 벌써 차있더라	결혼적령기가 지나면 결혼하기 힘들겠지?	1
좋아했던 사람 영원히 잊을 수 없을까?	좋아했던 기억 영원히 없앨 수는 없을까.	0
하품이 자꾸 나오네	하품 나와	0
과일 먹어야지	과일 챙겨 먹어야지	0
방학은 너무 심심해	방학했더니 심심해	0
썸일 때도 질투함?	썸일 때도 질투나나	0
자꾸 미리 걱정해	혼자 앞서서 생각해	0
마지막 짐 갖다주러 가는 길	붙잡아보려 합니다. 후회하지 않게	1
여자한테 언제 설레?	여자한테 언제 설레?	0
기술 좀 배울까	기술 배울까	0
주제 넘은 짓 한거 같아	내가 주제를 몰랐나봐	0
힌트 좀 안주나	힌트 좀 줬으면 좋겠어	0
사랑한다고 말해줘	사랑한다고 말해	0
좋아하는 여자애한테 어떻게 관심 표현하는지 조언 좀.	좋아하는 여자애한테 어떻게 관심 표현하는지 조언 좀.	0
상황이 복잡하다	주변 상황이 힘들게 하는 것 같아	1
여사친이랑 사귀는 거 가능?	여사친이랑 연인 되는거 가능?	0
헤어진지도 어느덧 반년	헤어짐	1
알고보니 나만 바보네	야	1
기차 타고 여행 가고 싶어	기차여행 가고 싶어	0
오늘 기분은 설명이 안돼	오늘 기분을 뭐라고 해야하나	0
짝남이 고시생이면 기다려야 하나요?	짝남이 고시생이면 기다려야 하나요?	0
나보다 친구들을 더 좋아하는 여친.	나이를 먹을수록 새로운 사람 만나는게 두려워.	1
수업시간 내내 잤어	학교에서 계속 잠	0
화 참을 때 어떻게 하지?	화 참으려면 어떻게 하지?	0
혹시 그런 날 없나?	혼자 사랑하고 혼자 이별하고	1
완전 계탄 느낌	나 완전 계탔어!	0
마음이 예쁜 사람 만나고 싶어	마음이 착한 사람 만나고 싶어	0
예랑이 턱시도 멋져	예비 신랑이 턱시도 멋져	0
사랑의 끝은 뭘까?	사랑하고 이제 결혼해	1
만난지 100일	만난지 100일됐어	0
아직도 잊지 못하나봐	아직도. 아직 인가보다.	0
가슴 찢어지게 아파. 그 사람은 내 마음 알까?	가끔 짝남과 연애하는 상상을 해.	1
짝녀가 사귀던 사람이랑 헤어졌는데 좋아한다고 고백해도 되나.	짝녀가 사귀던 사람이랑 헤어졌는데 좋아한다고 고백해도 되나.	0
버스에서 매일 보는 사람	매일 타는 버스에서 보는 그 사람	0
길이 안보여	절망적이야	0
방에 먼지가 한가득이야. 언제 치워.	집에 먼지가 쌓였네	0
주식 막 떨어지네.	주식 망 한강 가자.	0
좋아하는 남자의 단점을 들었는데도 좋아.	좋아하는 마음이 안 생길 것 같다고 떠난 여자.	1
쉬운 게 하나도 없는 듯	다 어려워.	0
안주 추천 좀	안주 뭐 먹을까?	0
시계 소리 짱 커	시계침 소리가 크게 들리네	0
사랑.이별.추억.미련	사랑은 사랑으로 치유 한다는 그 말 믿어보려구	1
남자친구 영장 나왔대	남친 영장 나왔어	0
두번째 읽씹	뒤숭숭하네.	1
여자친구랑 어디 놀러갈까?	여자친구랑 어디 놀러갈까?	0
의심 받는 느낌적 느낌	의심 받고 있어	0
다크서클 턱밑에 있다.	다크서클 내려왔어	0
나쁜 마음이 듭니다.	나의 약점	1
다 혼자 해야 돼	혼자 할게 많네	0
놀아 줄거지	놀아줘	0
한달하고 2주가 지났는데 아직도.	한번의 기회쯤 있겠지 라고 생각했던 내생각이 어리석었습니다	1
짧다면 짧고 길다면 긴 일년간의 연애가 끝이났네	짧지 않은 세월이 정말 끝이 났네	1
다 그만 두고 싶다	다 그만하고싶어	0
방이 정리 해야 되는데 너무 어질러 놨었네.	방정리가 안돼	0
남자가 여자를 좋아할때 하는 행동이 뭐가 있나요?	남자가 여자를 좋아할때 어떻게 알아?	0
어느덧 한달.	어디서부터 어떻게 얘기를 해야할지.	1
별이진 후 무언가 사라진 날들.	보고 싶다고 만나달라고 연락하면	1
아무래도 헤어져야 할까 봐	아무일도 없었던 것처럼 살고 싶어	1
미친듯이 잡고 싶어.	믿음이 깨진여자	1
짝남이 모임 오면 좋겠다.	오늘 모임에 짝남이 나왔으면.	0
퇴근시간 왜케 안 오냐	퇴근시간만 기다려	0
랩 추천 좀. 나 좋아하는 남자애한테 잘 보이고 싶어.	나 좋아하는 남자애한테 잘 보이고 싶은데 랩 추천 좀.	0
좋아하는 사람 때문에 공부를 못하겠어.	좋아하는 사람 때문에 공부가 안 돼.	0
눈이 계속 뻑뻑해	눈이 뻑뻑해	0
스팸 문자 계속 와	스팸 문자까지 오네	0
결혼하고 나서 애 낳기 싫어졌어	결혼하고 애 낳는거 너무 힘들거 같아	0
사랑하는데 힘들어	힘들어	0
다른 생각하지 않고 공부하는 방법	잡념 없이 공부하는 방법	1
바람이 너무 많이 부네	바람 많이 부네	0
이것 또한 받아들이는 것이겠죠~??	이남자 마음을 모르겠어	1
나한테 관심이 없는 것 같은데 포기가 안돼	나한테 관심이 없는 것 같은데 왜 끈을 놓지 못할까?	0
만난지 1년됐어	우리 만난지 1년됐어	0
나는 못생겼는데 좋아하는 여자에게 연락해도 될까?	나랑 딱 맞는 사람이 있을까?	1
여자친구가 전화를 안해	여자친구가 전화하는 걸 안 좋아해	0
자니?	자?	0
매일 아침 정류장에서 보게되는 그	매일 아침 정류장에서 보게되는 그 사람	0
헤어진지 2달 되가는데 오늘 무지 힘드네	헤어진지 3개월이 지났네.	1
넌 충분히 좋은 사람이였어	네 꿈을 자주 꾸는데	1
사람 만나는 거 너무 어려워	사람 만나는 게 쉽지 않아	0
생각 안나는 방법 없나	생각할 시간을 달라고 한 남친	1
헤어진지 15일	헤어진지 1달	1
헤어진지는 좀 오래 됐어.	헤어진후 4일짼데 하 생각보다 진짜 힘드네	1
자꾸 졸게 되네	화장실!!	1
일이 끝날 기미가 안 보여	아직도 안 끝났어	0
운명 같은 사랑 가능할까?	운명이 있을까	0
사실 사랑이 뭔지 아직도 모르겠어	사랑이 뭔지 모르겠어	0
맘이 아푸네	매달리는거 안좋은거 같아.	1
이제는 숨막히고 괴로운건 좀 무뎌졌는데	이제는 후회 없네 .	1
셀카만 계속 찍어	여친이 셀카 너무 많이 찍어	0
학교에 심남 있는데 연락해볼까?	학교에 심남 있는데 연락해볼까?	0
몇 년 만에 썸 타는 거라 어떻게 연락을 해야할지 모르겠어	오랜만이라 어떻게 연락을 해야할지 모르겠어	0
똑 부러지게 말해야지	이번에는 분명하게 말해야지	0
결국 답왔는데.기다리지 말라네	결국 만나진 못하고 카톡으로 맘 전했네	1
엄마라고 자식방에 막 들어오면 안돼지	엄마가 내 방에 막 들어와	0
노래 잘하고 싶어	노래 잘하는 사람 부러워	0
헤어진지 한달이 되어가네.	헤어진지 25일째	1
술자리에서 그만 마시라고 해주는 짝녀 무슨 뜻일까요?	술 그만 마시라고 해주는 짝녀 무슨 뜻일까요?	0
이빨 아파	이 썩은 거 같아	0
취직하면 공부 안해도 될 줄 알았어.	취직하면 공부 안해도 되는줄 알았는데	0
너무 뻔뻔하게 구는데	자기 잘못은 모르고 엄청 뻔뻔해	0
지루함에 지쳤다네.	지친다	1
시계줄 다른 색으로 바꿔야지	시계줄 바꿔야지	0
새로운 사랑 찾아 이제는	이제 새로운 사랑 찾을래	0
되고 싶은 게 두 개야	꿈이 두 개야	0
밥 너무 많이 남음	밥 너무 많이 함	0
짝사랑이 이렇게 힘들줄을 몰랐어요.	짝사랑하는 기분이 뭔지 알아요?	1
동거하다 사랑이 식으면 어떡해?	동거하는데 이별 얘기 어떡게 해?	0
헤어진지 1달 정도 되었습니다	헤어진지 2달 다되어가는데	1
꿈이 자꾸 바뀌어	꿈이 다양해	0
헤어진지 세달이 다되가네	헤어진지 일주일만에 새로운 남자가 생긴 전여친	1
보통 좋아하는 애 생기면 어떻게 친해져	좋아하는 애 생겼는데 친해지는 방법	0
이제 마음 정리도 된 거 같은데	이제 보름 다되어가네	1
오래된 노래들 다 내 이야기 같아	재회했는데 변한게 없어	1
여기서 욕해도 됨?	잘가	1
도대체 어디서부터 잘못된걸까	주위에 아무도 없는 느낌	0
사람 홧병나게하는거도 가지가지	사람이 변하나?	1
술 잘 먹는다고 이야기해도 될까?	주량 센데 솔직하게 이야기해도 될까?	0
좋아하는 애를 내가 너무 우상화하는 것 같아.	좋아하는 애를 내가 너무 우상화하는 것 같아.	0
우리 가족 모두 모두 건강하고 오래오래 행복하게 해주세요	오래 사귀었으면 좋겠다	1
같이 보고싶어 올립니다	같이 해온 5년	1
여친이 나를 안 좋아하는데 내가 붙잡고 있는 것 같아요.	여친을 내가 붙잡고 있는 것 같아요.	0
여자친구가 갑자기 이유없이 화내	여자친구가 갑자기 이유없이 화내	0
이젠 너 때문에 오래된 노래들도 못 듣겠어.	이젠 붙잡을 수 도 없는 사람.	1
데이트할 시간이 없네	너무 바빠서 데이트할 시간이 없네	0
나 보고 잘 웃는 여자애 나 좋아하는 건가?	나 쉬운 남자 아니야	1
찜질방 가서 양머리하고 놀고 싶다.	찜질방가서 땀 빼고 계란먹고 싶다	0
정말 이해할수가 없네ㅜ	정말 화가 나	1
찔리는데.	그렇게 말하니까 찔려	0
연애스타일이 너무 다른 남자친구와 어떻게 얘기를 해야할까?	어떻게 얘기를 하면 덜 어색할까?	1
밖에 안나가고 이렇게 살고 싶어	앞으로 나가지 않고 이렇게만 살고싶어	0
여름 끝났으면	여름 빨리 지나갔으면	0
머리가 콕콕 쑤셔	편두통 왔어	0
돈이 없으면 연애를 하지않는게 맞는걸까.	돈이 없으면 연애를 하지않는게 맞는걸까.	0
남자친구와 진도가 보통 어때?	남자한테 언제 설레?	1
남자친구가 충고만 해서 상처받아	남자친구가 자꾸 충고해서 상처받아	0
문 안열림	문이 안열려	0
헤어진지 1년 뭐하는건지ㅋ	헤어진지 1달반정도 됬네	1
여자예요? 남자예요?	여자야 남자야	0
어떻게 심쿵하게 하지?	심쿵하게 하려면 어떻해야 하지?	0
둔한 편인데 이것만 예민해	다른 건 무감각한데 이건 예민해	0
예전 게임인데 재밌다	보드게임 재밌다	1
우리반 남자애가 나 좋아하는 걸 너무 티내.	우리반 남자애가 나 좋아하는 걸 너무 티내.	0
긴장돼서 땀나네	생각만 해도 땀나네	0
정규직 가즈아	정규직 될 수 있을까	0
헤헤 용돈 받았어.	용돈 받음	0
오늘도 한숨만 쉬다 하루 다 갔네	오늘따라 미치네ㅜㅜ	1
이해를 못하겠어?	말을 이해를 못해?	0
더워서 죽을 것 같아.	더워 미치겠다	0
집 나가서 혼자 살고 싶다.	혼자 살고 싶다	0
어느새 나이가 30이네.	어떡해	1
편의점 간식 먹어야지	편의점에서 먹어야지	0
사랑한다는것	사진을 지웠습니다	1
헤어지신 남자분들이나 여자분들	헤어지자는 말 듣게 됐네.	1
아파트로 이사 가고 싶다.	아파트에서 살고 싶다	0
상대가 먼저 만나자고 해서 만났는데 난 아닌 거 같대	상대가 먼저 만나자고 해놓고 난 아닌 거 같대	0
좋아하는 여자애랑 다른 반이 됐는데 어떡해.	좋아하는 여자애랑 같은 반이 됐어.	0
조카 입학 선물 뭐 사냐	조카 입학 선물	0
애기 언제 가질 거냐고 왜 묻는 거지?	확실히 좋아하는 데도 관심 있는거 티 안내려고 선톡 안하고 일부러 늦게 보내고 그러는 사람도 있어요?	1
눈이 너무 많이 와	눈 좀 안 왔으면	0
자꾸 폭식하는데 어떻게 고칠 수 있을까?	폭식증 어떻게 고칠 수 있을까?	0
사랑할 자격이 있나?	사랑할 자격이 있나?	0
모쏠 여자와의 썸	모쏠이랑 썸	0
동성애 어떻게 생각해	동성애 어떻게 생각해	0
남자친구가 키가 좀 작아	남자친구가 키가 작아	0
망각은 축복이고, 원망은 허황된거 같기도해.	매듭문자를 보냈습니다.	1
서로에게 맞추려고하는데 잘 안돼	맞추려고 하는데 잘 안돼	0
달리 보이고 싶은데 뭐할까	나를 바꿀 수 있는 건 뭐가 있을까	0
지금 자면 밤에 못 자는데 졸려	지금 자면 밤에 못 자겠지?	0
내가 오랫동안 좋아하던 사람이 날 몰라.	내가 좋아하던 사람이 날 몰라.	0
반복되는 하루	밤보다 자고 일어났을 때 더 힘들어	1
연일 최고 몸무게 갱신하네.	최고 몸무게 찍는 중	0
썸 타는 중인데 바빠서 연락 제대로 못하는데 이해해야겠지.	썸인데 바빠서 연락 제대로 못하는데 이해해야겠지.	0
으으~ 떨린다	내일 떨린다	0
혼자 노력하는 연애인 거 같아	나만 혼자 애쓰는 연애를 하는 느낌	0
짝남 내일 출국인데.	짝남 내일 출국인데.	0
사랑 받는 느낌을 못 받아	사랑 받는 느낌을 못 받아 봤어.	0
오랜 연애로 가족같은 느낌이야.	오늘은 그녀를 만나기로 약속한 날	1
그녀와 헤어졋습니다	그녀의 사진들 다 지웠어.	1
마음이 싱숭생숭해서 자꾸 여기다 쓰게되넹	마음이 싱숭생숭해서 자꾸 글을 쓰게 되네	0
우리가 좋다는데 부모님이 반대하시니까 넘 힘들다	우리 두 사람만 좋으면 되는줄 알았는데 아니었나봐	0
1년을 넘게 만났는데 어떻게 이럽니까	1년이 지났어도	1
어째야 할까	어찌해야 할까	0
아휴.	알고보니 환승이별 인것 같아	1
도서관 가서 공부해야지	도서관 가야지	0
2년의 꿈같았던 사랑 갑작스런 이별	2년이 지나서 첫사랑이 살던 곳 지나갔는데	1
아이라이너 그리기 귀찮은데 문신할까?	아이라이너 문신 해볼까	0
먹고 죽을 돈도 없어	돈이 천원밖에 없어	0
헤어진 남친에게 연락하고 싶은데 해도 돼?	진짜 아쉬운데 다시 연락해볼까	1
어찌해야 하나.	언제까지 이렇게 잊지못하고 힘들기만 할까	1
치매가 더 심해지는 것 같아 무서워	치매가 점점 심해지는 거 같아	0
짝남 줄건데 센스있는 선물 추천해주세요.	짝남 줄건데 센스있는 선물 추천해주세요.	0
인간 관계가 제일 어려운거 같아	사회생활에서 인간 관계가 어려워	0
놀리기 쉬운 대상인가봐	나 놀려먹기 쉬운가?	0
아 괜히 헤어지자고 했나봐	아 오늘 힘드네ㅜㅜ	1
나라사랑 큰 나무 배지가 상징하는 내용은 무엇인가요?	사랑니가 빠졌어요	1
좀 웃어주지	좋은 사람 많아	1
인형 선물하면 좋아할까?	인형 선물 좋을지	0
남자친구가 술주정 부려	남친이 자꾸 술주정 부려	0
가만 있어도 땀난다	아 땀난다	0
이렇게 끝나는 구나	오늘도 행복 시작!	1
짝남이 자취한다는데 필요한 거 사다주면 좋아할까?	짝남이 자취한다는데 필요한 거 사다주면 좋아할까?	0
여자 마음 알고 싶어	남자 마음 알다가도 모르겠어	1
결국 사고쳤내 또	결국 유료 상담을 받고야 말았네	1
마냥 신났던 시간	정말 잘 노는 우리 커플	0
딱 내 이상형이야	완전 내 이상형이야	0
사랑 힘들다	사랑하는게 좋기도 하지만 힘들기도 해	0
기다리는 것도 행복해	기다리는 사람 있는 것도 행복한 일이구나	0
친구라는게 뒷담화나 하다니 	친구라고 생각했던 애가 뒷담화 하고 다님	0
여자사람 친구 많은 남자친구 헤어져야겠죠?	여자친구랑 헤어졌네	1
냉장고에 김치도 없네	김치도 없네	0
나도 위로 받고 싶다	위로받고 싶은 날	0
내가 연락 끊은 짝남한테 다시 연락올 수 있는 법 좀.	짝남한테 다시 연락 올 수 있게 하는 법 좀 알려줘	0
나는 좋은데 잘 모르는 것 같아	내 맘 모르는 척 하는 걸까	0
시험 준비하면서 연애 가능	공시 준비하는데 좋아하는 여자 생겼어 어떻게 해	0
조금의 결심이서네	좀 무뎌졌나 했는데	1
성적 좀 좋았으면	공부 잘하고 싶어	0
개같이 되버렸어.	개같은 상황	0
조명빨 좋다.	조명빨인가	0
모른 척 하는 건지 모르는 건지	모른 척 하는건가	0
어떻게 벌주어야 할까.	어떻게 해야 할까?	1
좋아하는 여자가 헤어질 때까지 기다렸다가 결국 사귀는게 가능할까요?	좋아하는 여자가 헤어질 때까지 기다렸다가 결국 사귀는게 가능할까요?	0
봉사활동도 좀 해야 하는데	봉사활동 해볼까	0
카톡 2틀째 확인안하내	카톡차단에 이제는 프로필 비공개 당했어	1
여자친구가 눈치가 없어.	애가 눈치가 없어.	0
더워서 죽을 듯한 날씨야	더워 미치겠다	0
괜히 건들지 말라고	나 좀 건들지마	0
집착? 미련? 사랑?	짝남 잊으려구	1
집안 일 하기 싫어	방 치우니까 좋다	1
썸인지 애매모호해	썸인지 애매모호해	0
랜선 연애 어떻게 생각해?	랜선 연애 어때?	0
부디 더 힘내줘.	분노	1
실비 드는게 좋을까	실비 들까	0
맞추려고 노력하는데 힘들어	맞추려고 노력하는데 잘 안된다	0
사랑하는 사람을 두고 다른 사람과 결혼해야해	사랑하는 사람 말고 다른 사람과 결혼해야해	0
짝남한테 혼자 화나고.	짝남한테 혼자 화나고.	0
오늘은 교회 안가면 안될까	교회 가기 싫어	0
남자들은 여자가 본인 좋아하는거 눈치 못 채나?	남자친구 만들고 싶어	1
짝녀 있는데 소개팅 들어오면 받아도 되나요?	짝녀 있는데 소개팅 들어오면 받아도 되나요?	0
짝녀가 나를 떠보는 걸까.	짝녀가 나를 떠보는 걸까.	0
변기 막혔는데 아무 생각이 안 난다.	변기 막혔어	0
헤어진지 두달이 되었습니다.	헤어진지 어느덧 한달	1
이 명절을 어찌 보낼지.허허	이 좋은날	1
같이 놀러갈 친구가 없어	놀러가고 싶은데 같이 갈 친구가 없어	0
의자 너무 불편해	의자가 불편해	0
찬남자한테 연락 왔어	참 부질없다	1
짝남보다 더 나은 사람은 없을거야.	짝남보다 더 나은 사람은 없을거야.	0
견딜수 없을만큼 아파	정말 힘드네	1
눈썹 문신 어때?	니가 심어준 버릇	1
남자친구가 너무 귀찮아해.	남자친구가 너무 게을러.	0
그 사람이 저를 그만 좋아하게 하는 방법 있을까요?	그녀는 내가 좋아하는 것을 이용하는 거야?	1
3년연애이별	3년이란 오랜기간 연애를 하다보니 권태기가 찾아오네	1
노는 거 좋아하는 남자는 좋아하면 힘들겠지?	노는 거 좋아하는 남자는 힘들겠지?	0
이런 일상에서 휙 떠나고 싶어	일상에서 떠나고 싶어	0
위로 해 주세요.	윤종신 '좋니' 노래 가사가 엄청 와닿네	1
나는 못났는데 인기있는 남자에게 연락해도될까?	나랑 다른 애들 자꾸 엮는 애가 있는데 얘 나한테 관심있나?	1
엄마가 언니랑 나랑 차별해	엄마가 언니랑 차별해	0
왜 그럴까?	왜 내 블로그를 들어와서 볼까	1
이별에도 준비가 필요한 거겠죠?	이별은 받아들이는게 맞는건가보네.	1
도서관에서 항상 같은 자리에 앉는 여자가 계속 떠올라.	도서관에서 똑 같은 같은 자리에 앉는 여자애 계속 생각나.	0
불면증	붙잡고싶어	1
짝남한테도 철벽이게 돼 왜그럴까.	짝남한테도 철벽이게 돼 왜그럴까.	0
내가 이상한 사람같아	내가 이상한 건가?	0
돈이 하나도 없어	돈 없어	0
자꾸 나약하게 느껴져	나는 나약한 존재	0
첫사랑도 내가 보고 싶을까?	첫사랑도 내 생각할까?	0
싫어하는 눈치가 아닌 거 같은데	싫어하는건 아닌 거 같은데	0
그 사람에게 좋아하는 거 티 내는 방법 좀.	아직 저만 좋아하는데 같이 스터디하자고 해도 될까요?	1
지하철에서 겁나 멋진 사람 발견! 말 시켜 볼까	지하철에서 괜찮은 사람 봤는데 말 시켜 볼까	0
가족들이랑 서먹해졌어	가족들이랑 서먹해	0
이 기회는 내꺼야	이 기회 잡고 싶다.	0
남편이 다른 여자랑 카톡을 주고받는걸 봤어. 	우리 커플은 사랑의 온도가 다른 것 같아요.	1
지금 여친을 별로 안좋아하는 것 같아.	지금 여친을 별로 안좋아하는 것 같아.	0
행복할까?	행복하니?	0
한숨만 자꾸 나온다	한숨 나와	0
위로해줄 사람이 필요해	위로해줄 사람이 없어	0
군대 때문에 헤어져야하는게 고민임.	군인 남친 보고 싶어	1
친구 사이로도 못 지낼 것 같아.	친구 사이로도 못 지낼 것 같아.	0
그놈 생일이예요	그땐 몰랐습니다	1
프로필 사진을 보았는데	하 못참고 또 연락해버렸네	1
자꾸 생각나네.	자는게 두려움	1
하루종일 썸남 생각만 해. 괜찮을까?	하루종일 썸남 생각만 해. 괜찮을까?	0
짝사랑 하는 여자랑 뽀뽀하는 꿈 꿨어요.	짝사랑 하는 여자랑 뽀뽀하는 꿈 꿨어요.	0
사귀면서도 좋아하는 감정을 잘 못느끼는데 문제 있는 건가요?	사귀긴 하는데 좋은지 모르겠으면 문제 있는 건가요?	0
최선을 다했는데	최선을 다한 거 같은데	0
내가 좋아하는 사람과 나를 좋아해주는 사람	내가 좋아하는 사람과 나를 좋아해주는 사람	0
좋아하는 애 피하면서도 우울해.	좋아하는 애 피하면서도 우울해.	0
남자친구가 안놀아 줘	남자친구가 너무 바빠	0
전남친이 톡 차단했더라구	전여친 카톡 탈퇴 재가입 한거 같은데	1
점심 먹으러 갈까	오늘 점심 추천	1
샤워할 때 눈을 감으면	설레였던게 언젠인지	1
학교가  바뀌어야 할 것 같아	좋은 식당을 추천	1
사랑이 뭔지 모르겠어	사랑이 뭔지 도통 모르겠어	0
부팅 시간 너무 오래 걸려	컴터 부팅하는데 시간이 오래걸려	0
날아 가고 싶어	하늘을 날고 싶어	0
뭔가 해야 할까	아무것도 하고 싶지 않으면서 아무거나 하고 싶어	0
짝남한테 밤늦게 나오라고 했더리 진짜 나왔줬는데 저한테 호감이 있는 걸까요?	짝남한테 밤늦게 나오라고 했더리 진짜 나왔줬는데 저한테 호감이 있는 걸까요?	0
하늘은 정말 예쁘다	남자친구 응원해 주고 싶어	1
사랑의 힘은 진짜 위대한듯	사랑은 진짜 위대한듯	0
나 오늘 심쿵함	심쿵함	0
만난지 얼마 안됐는데 결혼해도 될까?	만난지는 얼마 안됐지만 좋은데 결혼해도 될까?	0
친구의 전여자친구가 좋은데 사겨도될까?	친구의 전여자친구가 좋은데 사겨도될까?	0
망고빙수 맛있다	빙수 맛있다	0
좋아했던 사람에 대한 트라우마 때문에 연애를 못하겠어.	좋아했던 사람에 대한 트라우마 때문에 연애를 못하겠어.	0
우리 반 여자애가 나를 좋아하는 것 같아.	우리 반 여자애가 나를 좋아하는 것 같아.	0
이제 1년도 지나고 성큼 가을이 왔네.	이제 그만 보낼려구	1
얘는 싸우기만 하면 연락이 안돼	어디까지 가야 끝이보일지	1
사랑하는데 미지근한 거 같아	내 맘 알아주면 좋겠다.	1
돈 모으는 재미가 있네.	돈 모으는 재미	0
관심 있는거 티 안내려고 선톡 안하고 일부러 늦게 보내고 그러는 사람도 있어요?	관심 있는거 티 안내려고 일부러 답 늦게 보내고 그러는 사람도 있어요?	0
반장이라서 힘들어	반장은 원래 힘들어?	0
일은 원래 혼나면서 배워?	원래 일은 혼나면서 배우는 거야?	0
대학 안가고 기술 배울까봐	대학을 꼭 가야할까	0
왜 저를 좋게 기억해주는 걸까	왠지 가슴한 켠이 먹먹하네	1
나 연락하지 말라고 단호하게 해줘.	연락하지 말라고 해줘.	0
내일 모의고사 본다	내일 모의평가다	0
편안하게 살고 싶다.	마음의 평화가 필요해	0
이별준비	이별통보를 받았습니다	1
오늘도 술마셔.	오늘도 출근을 합니다	1
주차장에 자리가 없어	주차할데 없어서 짜증나	0
권태기가 온 거 같아.	다투고 하지 말아야 할 말을 했어	1
저금통 깰까	저금통 털까	0
또 고백해볼까?	그냥 고백해볼까?	0
이제 그만 좋아하고 싶어.	이제 좀 지겨워진 거 같아	1
얼굴 너무 까매졌어.	얼굴 너무 탔다	0
좋아하는 애랑 전화하면	좋아하는 애랑 전화하면	0
나 그동안 뭐한거니	뻘짓 한 느낌 싫다	0
참아볼께	첫눈	1
왜 이별하고 다들 왜 연락을 끊는건가??	왜이리 생각이 날까	1
적당히를 몰라	적당히 좀 하지	0
휴대폰 액정 깨졌어	핸드폰 액정 깨짐	0
내가 좋아하는 사람이 날 좋아했으면 좋겠어.	내가 좋아하는 사람이 날 좋아했으면 좋겠어.	0
이별 , 그 아픔을 잊는 시간의 두려움이란	이별 3일째	1
내가 첫 연애래	내가 첫사랑이래	0
완전 재미 없거든	재미 없어.	0
뭐하냐?	뭐해?	0
카드가 못찾겠다.	카드가 왜 없지	0
아 놔 왜 사냐	왜 살까	0
퇴근길에 훅!하고 연락오네.	파혼한거 정말 잘했다	1
여자인데 먼저 다가가도 돼?	여자인데 먼저 다가가도 돼?	0
시험을 꼭 봐야하나 도망가고 싶다.	시험 보지 말까?	0
썸녀가 오디션 붙었대	회사 짝남오빠 게임 초대 톡 옴.	1
잊을 때.	잊지못한다면순수한겁니다	1
잠이 안와	장거리연애였는데	1
갈수록 힘이 드네	감정조절이 안되서 문자 보냈네	1
봄되니까 동물원 가고 싶다.	선풍기 더운 바람 나와	1
썸남이랑 벚꽃 놀이 가고 싶어.	썸남이랑 벚꽃 놀이 가고 싶어.	0
썸 탈 때가 그리워.	이제 썸 탈 때가 그리워.	0
사랑 받고 싶었은데	이 결혼 해도 될까	1
참견 좀 안했으면	이래라 저래라 참견 좀 안했으면	0
남편과 별거한지 3달 되었네	내 마음과 머리가 이해가 안가네	1
헤어진 여자친구에게 마지막 한마디 했습니다	헤어진 여친이 페북이나 인스타그램 사진 안지우는게??	1
사랑하는 사람은 표시가 있었으면 좋겠다	사랑하는 사람은 표시가 있었으면 좋겠다	0
외제차 갖고 싶다	외제차 타고 싶어	0
나를 진심으로 좋아해주는 사람이 생겼으면 소원이 없겠어.	나를 좋아해주는 사람이 있으면 소원이 없겠어.	0
이제 내 짝남 못봐. 군대 가거든.	이젠 짝사랑하는게 무섭고 두려워.	1
이별 400일.	이별 6일째	1
최근에 헤어진 짝남한테 연락하면 주변에서 욕할까?	최근에 헤어진 짝남한테 연락하면 주변에서 욕할까?	0
교보문고 왔어	서점 왔어	0
여자친구가 음식을 너무 적게 먹어	여자친구가 너무 적게 먹어	0
최악의 남자	추억은 힘이 없다.	1
여자들은 좋아하는 사람한테는 장난 잘 안 쳐?	여자들은 좋아하면 장난 잘 안 쳐?	0
큰 시험 앞두고 짝사랑 하는 사랑이 생겼어요.	큰 시험 앞두고 짝사랑 하는 사랑이 생겼어요.	0
벚꽃구경 가고싶다.	꽃놀이 가고 싶어	0
내 의지로 안되는 일인가봐	내 의지는 상관없나봐	0
나의 이별 이야기	나한테 지쳐서 떠난여자	1
결혼은 현실이지?	결혼적령기가 언제야?	1
침착해야지	정신없을수록 침착해야지	0
나 사랑하는 사람이 생겼어.	좋아하는 사람이 생겼어요.	0
남자친구가 스킨십을 너무 좋아해	남자친구가 스킨십 좋아해서 고민이 많다	0
이제서야 현실을 받아들이네	이젠 나의 스케줄로 돌아가야할때!!	1
좋아하는 여자애한테 화이트데이 때 사탕 주면 좋아할까?	좋아하는 여자애한테 화이트데이 때 사탕 주면 좋아할까?	0
나 좀 천잰인 듯	너 만든 사람 최소 천재	1
나한테만은 완전 솔직했으면	나한테 감추는 게 하나도 없었으면	0
오랜만에 결혼한 친구 만나고 왔는데.	오해했네 그리고 차단 ㅎㅎ	1
공허한 마음	과거의 나한테 화나	1
주변에서 다 별로라고 한 짝남 그냥 맘을 접어야할까?	주변에서 다 별로라고 한 짝남 그냥 맘을 접어야할까?	0
짝남 나한테 마음 있는지 궁금해.	짝남 나한테 마음 있는지 궁금해.	0
내가 너무 쉬워 보이게 행동했나봐	내가 쉬워보이나?	0
너무 힘듭니다	너무나 와닿는그런 표현이 아닐까 하네	1
나만 그대로다	나만 힘든건지	1
냄새 나면 어쩌지?	나한테 냄새 나면 어쩌지?	0
내려 놓으렵니다	내일 그녀 생일이네	1
무서워요	너 무서워	0
허전하다	마음이 허해	0
짝남 여친 있는지 없는지 어떻게 알아내?	짝남 여친 있는지 없는지 어떻게 알아내?	0
보고싶다고 말하니까 더 보고싶다.	새로운 사랑을 원하는것도 아닌데.	1
이별 고통	이별 다음날	1
낭만이 사라진 것 같아	낭만이 없어	0
이쁜 구석이 없어	좋은 점이 없어	0
바람난거 알고 헤어졌습니다.	바보라서 참지못하고 연락했어	1
잠깐 쉬려고 했는데 한참 지났네.	잠시만 쉬려고 했는데 길어졌어	0
케익 만들어서 선물할까?	케익 직접 만들어볼까?	0
이렇게 사랑 받아도 되나?	사랑 받아도 되나?	0
나 또 짝남을 2년동안 좋아하는 건가.	나 사랑해서 만나는 거겠지?	1
친한 친구의 구남친이랑 사귀어도 될까요?	친한 친구의 구남친이랑 사귀어도 될까요?	0
연락하면 짝남이 받아줄까	짝남한테 고민상담 해달라고 해볼까?	1
잊지못할줄 알았는데	잊혀질까?	1
짝남이랑 카톡이 끊겼는데 어떻게 더 연락할까?	짝남이랑 카톡이 끊겼는데 어떻게 더 연락할까?	0
한달전에 마음 변한걸 느꼈을때 헤어질 것을.	한번 마음이 떠난 여자는 다시 안돌아오나 ?	1
마음정리	마지막 도전	1
가난한 자의 설움	돈 다 썼어	0
남편이 짜증나게해	남편이 미워	0
그 여자가 좋아	뒤에서 욕하는 사람 용서하는 방법	1
짝사랑 중인데 이 세상에 나만 힘든 것 같아.	짝사랑 중인데 이 세상에 나만 힘든 것 같아.	0
3년간 만나던 여자친구와 헤어졌어	헤어진지 3년이 지난 지금	0
결국 이렇게 끝나버리네	결국 찾아갔네.!	1
짝남과 자연스럽게 친해질 수 있는 방법 있을까?	짝남과 자연스럽게 친해질 수 있는 방법 있을까?	0
짝남도 나 좋아하는지 어떻게 알지	짝남이 좋다했던거 페북 태그해도 되나?	1
새폰 케이스로 새옷 입혀 줄까	폰 케이스 사줄까?	0
여자친구가 예쁜데 착하기까지해	여자친구가 예쁘고 착해	0
그녀는 조금이라도 내 생각을 할까?	내 생각을 할까?	0
나만 좋아하는 것 같아	혼자 좋아하는 것 같아	0
첫만남장소 어디가 좋을까요 	여자친구 있는지 어떻게 알아	1
짝남 보란듯이 성공하고 싶어요.	짝남 마주치지 않으려고 노력할거야.	1
헤어졌을때는 자신을 바쁘게 만드는 게 제일 좋은 방법인듯	헤어지고 나니 많은 생각이 들어	1
일이 안 끝나	사업 시작해도 될까	1
왜 결혼 안하니 묻지 좀 마	왜 결혼 안하니 묻지 좀 마	0
장거리 연애하면 보통 몇일에 한번 만나?	장거리 연애하면 보통 몇일에 한번 만나?	0
짝남이 졸업하는데 뭘 주면 인상깊을까?	짝남이 졸업하는데 뭘 주면 인상깊을까?	0
너도 고민 있어?	넌 고민이 뭐야	0
매주 화요일 그를 볼 수 있어.	매주 화요일 그를 만나 볼 수 있어.	0
썸남이랑 끝인 것 같아. 촉이 와.	썸남이랑 끝인 것 같아. 촉이 와.	0
짝사랑하다고 솔탈함. 기 받아가.	짝사랑하다고 솔탈함. 기 받아가.	0
사실 관계 7년을 정리했습니다.	사진첩	1
봉사도 하고 사랑을 베풀고 싶어	다른 사람들에게 사랑을 베풀고 싶어	0
대학 떨어 졌어 휴	대학 다 떨어졌어	0
엿같다.	엿같은 상황	0
배려가 너무 없어	배려가 없어	0
헤어지고 들으면 좋은 노래는 무엇입니까?	이별 후 듣는 노래 알려줘	0
여러분 제가 느낀바입니다	여자친구 같았던 썸녀	1
나를 이해해 주는 사람이라서 다행이다	떡볶이 먹고 싶어	1
꿈이 너무 무서웠어	무서운 꿈 꿨어	0
이모티콘 기간 끝나서 없어졌어	이모티콘 기간 끝났어	0
에어콘 잘 나오는 카페 가서 피서해야겠다.	너는 지금 무슨 생각할까	1
남자친구 휴대폰 봐도 되나	남친 핸드폰 비번 아는데 봐도 되나	0
장마인데 건조기 사는게 좋을까	건조기 살까봐	0
남친이 워커홀릭이야	남친이 일만해	0
전화는 왜 갖고 다녀! 안받으면서	전화 또 안 받네	0
여자친구가 나 사랑하는 건지 확신이 없어	여자친구가 나 사랑하는 건지 확신이 없어	0
역류성 식도염 온 거 같아.	역류성 식도염이 또 도졌어	0
썸 맞는지 궁금	우리 썸 맞는거임?	0
아 또 참지 못하고 카톡 프사를 봐버렷네	아 정말 지옥이네.	1
연애를 실패할 수록 두려워. 좋은 사람 만날 수 있을까?	좋은 사람 만날 수 있을까?	0
헥헥 더워	더워 죽겠다	0
고백조차 못해보고 끝났어	고백도 안했는데 싫어하는 것 같아	0
마중 나가볼까?	오늘은 마중 나가볼까?	0
답정녀 좀 싫어	답정녀 어떡해?	0
일어났더니 목이 잠겼어	자고 일어났더니 목 아파	0
짝남이 나한테 먼저 연락왔으면 좋겠어.	짝남이 나한테 먼저 연락왔으면 좋겠어.	0
친구네 갔다올게	친구네 놀러가려고	0
여자친구가 너무 많은 걸 기억하길 바라는게 고민임.	여자친구가 너무 많은 걸 기억하길 바라는게 고민임.	0
출퇴근 빡세	번아웃 막는 방법	1
걔는 행복하게 살텐데	거짓말은 진짜 못고치는 병 맞죠?	1
연락을 해봤는데 안받네.	연락하고 지내는데	1
감정싸움 그만하고 싶어	자꾸 싸우게 돼	0
미안한 마음에	미워할수 없는 그대	1
평가원 시험 잘 봐야 할텐데	평가원 잘 보고 싶다	0
차 살거야	차 사야 할 거 같은데	0
좋아하는 여자가 너무 철벽이야.	여자가 너무 철벽이야.	0
아침마다 왜 이러는지	아침부터 또 눈물이 나네	0
전기가 갑자기 나갔어	전기 안들어와	0
혼자 여행 가도 안전할까?	혼자 여행 재밌을까?	1
진급에서 나만 누락됐어	진급에서 나만 빠졌어	0
헤어진지 1년.	헤어진지 1일차.	1
신혼인데 남편이랑 자주 부딪혀	신혼인데 남편이랑 자주 부딪혀	0
나라사랑대출 서류 간소화 요청	사랑에 관한 짧은 성경구절	1
노트북 사줘	나 노트북 사줘	0
썸인데 선물해도 돼?	썸인데 선물해도 돼?	0
일요일에 데이트 해야지!	주말에 데이트 해야지!	0
엄마랑 둘이 여행가	엄마랑 여행 안 가봤는데	0
여자들이 싫어하는 남자들 특징 좀 알려주세요.	여자들이 싫어하는 남자들 특징	0
로또 당첨 번호를 불러 주세요	로또 번호 알려줘	0
좋아하는 사람이 너무 예뻐	좋아하는 사람이 너무 예뻐	0
썸 오래타는 건 재보는 거 아냐?	썸 오래타는 건 재보는 거 아냐?	0
꼴 사나워질 것 같은데	나만 우스워질거 같아	0
아기 키우는거 너무 어려울 것 같아	아기 키울 수 있을까	0
달콤한 와플 먹고 싶어	와플 먹고 싶어	0
콜록콜록	감기 걸린 거 같아	0
동성을 사랑해	동성이 좋아	0
애완동물 키우고 싶은데 아빠가 못 키우게 해	애완동물 키우고 싶은데 아빠가 키우지 말래	0
힘들고 지치네	힘들어.너무 힘들어	0
힘드네	힘들 거라고 말했는데	1
커플 여행 가면 잘 싸워?	커플 여행 가면 잘 싸울까?	0
좋아하면 이용당해도 되는거야?	좋아하면 이용당해도 되는거야?	0
오싹한 이야기 해줄까	와 연락하고싶다.	1
친구가 소개해줬는데 이상한 사람이었어	친구가 이어줬는데 안 됐어	0
우왕 썸남이 데리러 온대.	썸남이 데리러 온다고 하는데 신난다	0
그만 먹어야 하는데	먹을까 참을까	0
넋두리	넌 행복하네	1
내가 여자친구의 전남자친구보다 능력이 부족해.	전남자친구보다 능력이 부족해.	0
좋아하다 더 좋아지는 게 사랑인가?	좋아하다 더 좋아지는 게 사랑인가?	0
너무 힘들어서 심장이 터질 것만 같아	너무 힘듭니다	0
일을하다가도 잠을 자다가도	일주일전까지만해도.	1
셀프웨딩 어떨까?	셀프웨딩으로 준비 해볼까	0
쓸모 없게 느껴져	내가 쓸모없는 인간 같아	0
잊자 잊자 지워버리자	잊혀지네.	1
이름 알려줘	이름이 뭐야	0
정리 불가	정리가 안돼	0
너라서 행복해	너라서 행복해	0
사랑할 시간이 없어.	사랑할 여유가 없어	0
그래도 좀 기대했는데	기대했는데	0
춥네	날씨가 무지 추워.	0
이별후 한달째 인데	이성간 종교문제	1
나만큼 힘들지 않았으면 좋겠습니다	나없이행복한가봐	1
커피가 없으니까 집중이 안 되네	커피 없으면 집중이 안돼	0
하는 일 없이 피곤해	오늘 일도 안 했는데 엄청 피곤해	0
뒤숭숭하네	드디어 연애에 종지부를 찍은것 같네	1
남자친구 콧대가 높아서 잘 생겼어	남자친구 코가 높아	0
좋아하는 오빠랑 친해지는법	좋아하는 오빠랑 어떻게 친해질까.	0
지진 안나겠지	지진나면 어떡해?	0
남자친구 스타일이 마음에 안들어.	남자친구 스타일이 바꿔 주고 싶어.	0
사랑하는 사람한테 내가 너무 모잘라	그 사람한테 내가 너무 모잘라	0
술기운을 빌려 무작정 찾아갔습니다	술 한잔 했더니 너무 보고 싶네. 	1
핸드백 선물 해도 될까	빽 선물 해도 될까	0
전 썸남 보고싶어.	전 썸남 보고 싶어.	0
이젠 슬픈 사랑	이젠 정말 놔줄라고	1
8년 사귀고 해어지려 합니다.	8년의 연애의 끝에 와있습니다.	1
일찍 일어나야 돼	내일 일찍 일어나야 돼	0
차였지만 잊지못하고 있는 한 남자입니다.	찬 사람은 후폭풍 없나?	1
여자친구가 힘들어하는데 내가 뭘 해줄 수 있을까?	여자친구가 힘들어하는데 내가 뭘 해줄 수 있을까?	0
사랑받는 행복을 알게 해준 너	사랑받는 행복을 알게 해준 너	0
여자친구 패턴 몰래 봤어	여자친구 패턴 몰래 봤어	0
남자친구가 잘생겨서 인기가 거의 아이돌급이야	남자친구가 인기가 거의 아이돌급이야	0
불효자는 웁니다.	내가 불효자야	0
헤어스타일 좀 바꿔볼까?	머리스타일 바꿔볼까?	0
짝사랑 그만할래	짝사랑 그만하고 싶다	0
썸이 뭐임	썸이 뭐야	0
남자친구 오늘 좀 질린다.	남자친구한테 질린 거 같아	0
벌써 일년	별 그지같은 이유로 헤어지자네	1
썸남한테 소개팅 나간다고 해볼까?	썸남한테 소개팅 나간다고 해볼까?	0
아침 등교할때 버스정류장에서 항상 마주치는 짝녀에게 말 걸어보고싶어.	혼자 좋아하는 이야기.	1
다시 꼭 잡겠다는 결심	다시 만나자는 말 하기 전까지 연락 안 하게	1
발 아파	발 부었어	0
금수저로 태어났으면	금수저로 태어났으면 좋았을텐데	0
강아지 귀여워 심쿵	강아지 밥 먹는거 귀여워	0
어떻게 프로포즈 하지?	프로포즈 잘 하는 방법?	0
바보짓 그만 둘래	반복되는 맘의 준비	1
헤어진지 벌써 1년이 다 되가네	우리 사귄지 1000일 됐어	1
하루종일 회사에서 미친사람처럼 눈물의 의미를 생각하면서	하아 다시 또 터진 눈물	1
후배가 나보다 잘해서 속상해	후배보다 못해서 짜증나	0
올해 왜 이렇게 엉망이지	올해 왜 이러지	0
문자 왔다는데 읽다가 눈물샘 터졌어	뭐라도 해야 살거 같은데.	1
드디어 개강이다	개강이다	0
신발 새로 샀다	새 신발 샀어	0
택시비로 돈을 너무 많이 썼어	택시 너무 많이 탔어	0
짝녀 오랫동안 멀리서 지켜보기만 하고 있습니다.	짝녀 오랫동안 멀리서 지켜보기만 하고 있습니다.	0
격려가 필요해.	격려 좀 해줘	0
난 동물 못키울거 같아	나같은 사람은 동물 키우면 안되겠지	0
이별 한달 후.	이별 후 7개월,,	1
우울하네	운이좋은건지 나쁜건지	1
나는 나름 최선을 다했는데	최선을 다한 거 같은데 결과가 ㅠㅠ	0
내 의견 지지해 주는 있었으면 좋겠다.	뭔가 아이러니하다	1
뭔 날이여?	오늘 무슨 날인가	0
자주 못보면 멀어지겠지?	롱디인데, 몸에서 멀어지면 맘에서도 멀어진데	0
어디론가 훌쩍 떠나고 싶다	어떤 마음이었을까?	1
견딘다는 것	결국 또 꿈꿨네.	1
그말 하지 말걸	그쪽은 너무 편안하고 즐겁게 지내.	1
헤어졌습니다	헤어지고 2년 정도에 느끼는 것들	1
동문서답을 해.	자꾸 동문서답이야.	0
눈 많이 왔어	눈 쌓였어	0
간간히 동굴에 들어가는 남친 어떻게 해야돼?	강아지 좋아하는 남자 어떤 것 같아?	1
괜찮아 사랑이야	괜찮은 사람 발견함. 여친 있는지 물어봐도 됨?	1
월급이 안 오르네	월급은 안 오르고	0
시험 끝나고 우리 만나자	시험 끝나고 만나고 싶어	0
너무하네 진짜	너에게 쓰는 편지	1
썸인데 떠보는 거 같아요	썸인데 떠보는 거 같아요	0
남긴게 없이 줬다고 믿어.	남자가 못잊는 여자	1
혼자 이별여행이라도 갔나	혼자 해야 돼	1
진짜 이제 한계야	여기까지가 한계야	0
사랑이 식었어요	사랑의 정의	1
비행기표가 왜이렇게 비싸	비행기표가 너무 비싸	0
얼굴만 아는 민망한 사이가 있어	아예 모르는 것도 아니고 얼굴만 아는 민망한 사이가 있어	0
예전 직장선배 언니가 해준이야기가 생각나네.	오늘 다시만나보니 정리가될것같아	1
오늘 저녁 뭐 먹을까	오늘 저녁은	0
근육 있으면 멋있을텐데	운동 잘하는 사람 멋있어	0
마지막 작별 문자	마지막 문자	0
수건 썩었어	수건에서 냄새나	0
장기자랑 왜 시켜	장기자랑 안 시켰으면 좋겠어	0
기념일 다 챙기는거 귀찮아	기념일 챙기기 귀찮아	0
너무 어려워	모든 일이 어려워	0
5년간 사귀고 이별	5년 연애후 이별	0
용기내볼까?	용기내볼까?	0
답답하네요	진짜 속상해..	0
축제날은 즐겨야지	학교 축제를 즐겨야지	0
잘 살고 있니?	잘 지내고 있니	0
결혼이나 하지 왜 자꾸 나한테 화 내냐구!	계속 생각난다면 연락 한 번 해봐야겠죠?	1
취업준비하는데 연애해도 될까?	취업준비하는데 연애해도 될까?	0
언제쯤 잊혀질런지	언젠간 내 기억 속에서 서서히 지워지겠지.	1
좋아하는 남자애랑 같은 반이 됐는데 너무 떨려.	좋아하는 남자한테 여친이 있는데 헤어졌으면 좋겠어.	1
사랑이 안 변했으면 좋겠다	사랑하는 마음 변치 않았으면 좋겠다	0
습관이 안 고쳐져	습관 못 고치겠어	0
기댈 수 있는 사람이 이상형이야	힘들 때 기댈 수 있는 사람이 이상형이야	0
나 화장이 잘 안돼	나 화장을 너무 못해	0
뭐야 너무 건방져	건방져	0
짝녀한테 고백했는데 짝녀가 오해하게 해서 너무 미안하다네요.	짝녀한테 고백했는데 짝녀가 오해하게 해서 너무 미안하다네요.	0
오래됐는데도 첫사랑 보고 싶어	고등학교 때 첫사랑 보고 싶어	0
동료가 너무 게을러	게으른 동료가 있어	0
스킨 없다	스킨 떨어졌다	0
진짜 피곤한 날	오늘 너무 피곤해	0
짝남이 날 너무 편하게 생각해.	짝남이 날 너무 편하게 생각해.	0
때를 기다립니다.	떠나보내지지가 않아	1
나를 사랑하지 않는다네	나만 구질하게.ㅜㅜ	1
놀이공원 알바하면 재밌겠지	놀이공원 알바 재밌대	0
동거 헤어짐 그 후	동거 후 헤어졌어	0
외로움이 커져.	외로움에 연속	1
내 사랑이 끝났어	사랑 이후	1
내가 좋아하는 애를 내 친구가 계속 욕하는게 맘에 안들어.	내가 좋아하는 애를 내 친구가 계속 욕하는게 걸려.	0
나는 아닌가봐	이렇게 끝나는 건가	1
좋아하는 사람이랑 친구 가능해?	좋아하는 사람이랑 친구 가능해?	0
아이고 추워라	추워	0
아빠 술 좀 끊으라고 해줘	아빠가 술 너무 많이 먹어	0
우연히 마주쳤어	우정이란게 뭘까	1
뭔가 취미생활 필요해	취미 좀 만들어볼까?	0
살 만한게 없네	살 게 없네	0
이사람이랑 결혼해도 되겠지?	결혼이 맞는 걸까?	0
라면 맛있게 끓이는 법 알려줘	라면 잘 끓이는 법	0
썸남이 데리러 온다고 하는데 뭐라고 반응해?	썸남이 데리러 온다고 하는데	0
머릿속이 복잡해	머릿속이 정리 안돼	0
사랑이 애매해	사랑인가? 애매하다	0
썸 타는 거 때문에 친구들이 놀려	썸 타는 거 때문에 친구들이 놀려	0
다시 만나자는 건 아닌데 보고 싶어	헤어지기 전으로 돌아가고 싶은건 아닌데	0
새로운 베프가 필요해	새로운 베프를 만들고 싶어	0
버스 멀미하는 것 같아	버스 멀미나	0
일기 써야 되는데	일기쓰기	0
여자친구 집까지 데려다주려고	여자친구 집까지 데려다주려고	0
헤어지고 두번째 연락	헤어지고 연락했습니다.	1
스터디 카페 좋다	스터디 카페 왔어	0
사랑은 상처를 남기고 가	사랑의 유효기간	1
짝남이랑 잘됐으면 좋겠다.	짝남이랑 잘됐으면 좋겠다.	0
8년 긴 연애의 끝.	8년 사귀고 헤어짐	0
남자친구가 누나가 두명이라 그래서 결혼 걱정돼	남자친구가 누나가 두명인데 결혼하면 힘들겠지	0
정리하는 중	정말 끝이라고	1
괘씸하고 분하지만 너무 그립습니다	괜찮아 지고있었는데 에효	1
나 좋아하는 줄 알았는데.	내 사랑인줄 줄 알았는데.	0
피곤해 죽을 거 같아.	매일 매일이 피곤해	0
너무 설레서 울렁거려.	설레서 울렁거려.	0
같은 회사에 좋아하는 여자가 생겼어	같이 일하는 사람에게 어떻게 연락을 시작할까?	1
더 격렬하게 아무 것도 안하고 싶다.	하루 종일 아무것도 하기 싫어	0
남자친구가 자꾸 잔소리해	남자친구가 잔소리가 심해	0
이별을 하는게 나을까	이별의 시간	1
남자친구가 너무 좋아	남자친구 많이 사랑해	0
이마야 운동장이야	이마가 너무 넓어	0
썸 타던 선배가 연락을 안해	썸 타던 선배가 연락을 안해	0
자꾸 자다 깨	자다 깨다 해	0
너 너무 귀여워	밀린 설거지 좀 해줘봐봐	1
깜짝이야 소오름이 쫙 	놀라서 소름이 다 돋았아.	0
문열다 옆차랑 부딪혔어.	문콕한듯	0
긴 머리 관리 어렵다.	긴 머리 관리하는 거 힘들다	0
주식 올랐어.	주식 덕분에 돈 좀 벌었어.	0
좋아하는 사람이 있는데 씨씨야. 만나도 될까?	씨씨인데 만나도 될까?	0
내 의견 좀 존중해 줬으면	내 의견을 존중해줬으면	0
쉬운 게 하나도 없는 듯	뭐 이렇게 쉬운 게 없지	0
띠동갑 짝사랑하는데 괜찮을까.	띠동갑이 좋은데 괜찮을까.	0
다음주에 전 여자친구를 보기로 했어	답답증	1
알바 면접 보러가.	알바 면접 합격했어.	1
노래방 가고 싶어	친구들이랑 노래방 가고 싶어	0
니가 이 글을 봤으면	다 내려놓았더니.잊혀지려고는 하는데	1
혼자가 좋다는 짝녀에게 들이댔음.	혼자가 편하다는 짝남에게 먼저 대쉬해버림.	0
결국 제가 병신인거죠.	결국 헤어졌네	1
아직도 모르는게 너무 많은 것같아	나 모르는게 왜 이렇게 많지	0
하루 종일 붙어 있고 싶어	하루 종일 같이 있고 싶어	0
카페에서 이상한 사람이 자꾸 쳐다봐	카페에서 모르는 사람이 자꾸 봐	0
썸 타다가 고백하고 차였는데 연락해도 될까	썸 타다가 고백하고 차였는데 연락해도 될까	0
썸타던 여자가 갑자기 돌아섰어	썸타던 여자가 갑자기 돌아섰어	0
아무 생각이 안든다.	머릿속이 하얘졌어	0
완전히 끝나버린 사이?	왜 그것만 삭제했을까	1
눈 오니까 그 사람 생각이 나네	눈 오니까 군고구마랑 호떡 먹고 싶다.	1
좋아하는 애가 자자고 해서 자버렸어. 어떡해?	좋아하는 애가 자자고 해서 자버렸어. 어떡해?	0
계속 그 사람 생각만 해.	고마워.	1
주식으로 돈 많이 벌었어	주식 대박 남!	0
내 맘대로 되지가 않아.	내가 더 사랑할까?	1
매일 그녀 꿈을 꾸네	매정하게 내치고 이별 통보한 그사람	1
여기 아이들 천국이네	애들 놀기 좋게 잘 해놨네	0
내가 너무 보수적인걸까?	나 보수적인걸까?	0
우울증 도진것 같아.	운동을 통해서 극복하고 있습니다.	1
오늘 라면 먹고 싶어	오늘 라면 먹어야지	0
친한 친구의 구여친이랑 사귀어도 되나.	친한 친구의 구여친이랑 사귀어도 되나.	0
내 왜 좋아할까?	내가 사랑했던 그 사람 맞아?	1
오늘도 힘차게 시작	힘차게 시작	0
날씨가 북극같아	날씨가 너무 추워	0
휴가 고고	휴가 가야지	0
오늘은 그냥 혼자 있는게 좋아	다 귀찮고 혼자 있고 싶다	0
그녀와 운동하던 헬스장 짐 정리 하러 갑니다	그녀의 남자사진을 봤습니다	1
오늘 서점에서 이상형 봤어	오늘 서점에서 이상형 봤어	0
밥 먹다 옷에 흘렸어	밥 먹다 흘렸어	0
썸남이랑 영화 뭐 보지	영화 뭐 보지	0
군대 갔다 올 때까지 기다릴 수 있을까	군대 기다릴 수 있을까	0
왜 갑자기 연락했을까?	왜 이제서야 연락했을까?	0
상의도 안하고 왜 혼자 결정 하지?	상의도 없이 왜 그런 결정을 하지?	0
비가 와서 걱정했는데 금방 그쳤어	비 오기 전에 집에 와서 다행	1
골프 어려워	골프 못 치는데	0
아날로그 감성 좋다	아날로그가 좋아	0
사랑에 유효기간이 있을까?	통조림 유효기간 지났어	1
하루는 괜찮고 하루는 아픈. 반복되는 일상	하루하루가 너무 고통스럽네	1
나이가 많은데 취직이 될까	취직하는데 나이가 많아	0
썸인지 헷갈려	썸인지 확인하는 방법 있나	0
나 욕 먹는 거 같아	남들이 날 욕하는 거 같아	0
그냥 흔한 이별 그리고 넋두리	그녀 생일	1
계속 한숨만 나와	왜 계속 한숨 나오지?	0
난 여자인데 남자를 좋아하는게 맞는지 모르겠어.	남사친이 나를 좋아하는 것 같은데 어떡함	1
영어 좀 잘했으면	중국어 배우고 싶어	1
소개팅 한 사람이랑 내일 만나기로 했어	내일 데이트 있는데 설레	1
꿈은 많은데	꿈이 너무 많아	0
날씨가 차서 그런지	남동생한테 자꾸 화내게 되네	1
내일 약속 있는데 날씨 좋았으면	낼 데이트하기로했는데 날씨 좋았으면	1
맥주 마셔야지	맥주 한 잔 해야지	0
여자친구랑 남사친이 너무 친해.	여자친구랑 남사친이 너무 친해.	0
싸울 때 이겨낼 수 있는 방법이 있을까?	싸울 때 이기는 방법이 있을까?	0
잘 살고 있겠지?	잘 사니?	0
오늘도 퇴근길 엄청 막히네	퇴근길 엄청 막히네	0
이상적인 관계는 뭘까?	이상적인 관계는 뭘까?	0
사랑 표현에 서툴러	사랑한다고 표현하는게 힘들어	0
이어폰 까먹지 말고 사야지	이어폰 사야지	0
조용히 지나갈까?	조용히 지나가면 될까?	0
아내한테 만족해?	아내한테 만족해?	0
상대와 헤어지고 돌아오는길	상처가 빨리 나았으면좋겠다	1
눈을 감아도 보고 싶어	대학교 고학번 선배랑 썸 타도 되나?	1
난 왜 예쁘게 말을 못할까	말 예쁘게 하고 싶어	0
다시 만나서 이야기해 보고 싶은데 달라지지 않겠지	다시 만나서 이야기하면 달라질까	0
짝남이 사귀던 사람이랑 헤어졌는데 내가 고백해도 될까?	짝남이 사귀던 사람이랑 헤어졌는데 내가 고백해도 될까?	0
내가 좋아하는지 그 애가 아예 몰라.	내가 좋아하는지도 몰라.	0
한달만에.제가	한달이라는 시간이 흘렀습니다.	1
여자친구가 좋은데 왠지 모르게 귀찮아.	여자친구가 좋은데 왠지 모르게 귀찮아.	0
인연은 항상 소중한 거겠지	인연은 소중한 거지	0
또 한달이 지나갔네	달력이 또 넘어가네	0
너에게 쓰는 나의 마음편지	너한테 또 안보낼 편지	0
선 결혼 후 연애 해도 될까?	결혼하고 나서 연애 해도 될까?	0
여자친구가 자꾸 질리게 한다	여자친구한테 질린 듯	0
말을 수시로 바꾸는 사람 어떻게 해?	자꾸 말 바꾸는 사람 어떻게 해?	0
고구마 피자 먹고 싶다.	오늘따라 피자 땡기네	0
난방비 비싼데 추워	가스비 비싼데 감기 걸리겠어	0
나빼고 다 행복한 거 같아	다들 행복한 거 같은데	0
축제 준비하느라 바빠	학교 축제 준비하느라 바빠	0
짝사랑 해봤어?	짝사랑 해봤어?	0
남자친구가 돈이 너무 없어.	남자친구가 돈이 너무 없어.	0
내일은 기다리던 소풍 간다	내일 소풍간다	0
밤인데 전화해도 되나	늦은 시간에 전화해도 되나	0
엄마한테 손 좀 벌려야겠다 	용돈 달라고 졸라볼까?	0
누가 내 욕하는 거 같아	남들이 다 손가락질 하는 거 같아	0
직장인도 방학 필요해	방학이 있었으면.	0
정시 퇴근하고 집에 가는 중	일찍 퇴근하고 쉬고 있어	1
예능도 이제 재미없어	예능 볼 게 없다	0
어떡해야 될가?	어떻게 맘정리를 할까?	0
짝녀랑 연락이 끊겼는데 더 연락하고 싶어.	짝녀랑 연락이 끊겼는데 더 연락하고 싶어.	0
남자친구가 많이 먹어서 무한리필만 가	남자친구가 많이 먹어서 무한리필집 너무 자주 가	0
장 봤는데 다 비싸	장 봤는데 후덜덜해	0
이제 그만해야겠죠?	이제 너무 지쳐가네ㅠ	1
간단하게 사랑이라는건.	감각이 무뎌질 때도 된 거 같은데	1
짝사랑 하면서 내가 초라하게 느껴져.	짝사랑 하면서 내가 초라하게 느껴져.	0
아픔은 빨리 잊혀지는법	안녕하세요	1
꿈에서까지 힘들게 하냐	꿈이라는 무방비상태	1
기다리는 것도 지쳐	이제 기다리는 것도 지쳐	0
여자친구 말고 다른 여자도 만나보고 싶어.	여자친구 말고 다른 사람도 만나보고 싶어.	0
이별 후 감정	이별 후 만남	1
이별을 준비중.	이별의 고통 중에 가장 큰 건 기다림인거 같아	1
배 아파서 기분이 안 좋아	배 아프다	0
자꾸 우연히 만나	우연히 또 만났어	0
내가 좋아하는 사람이 날 좋아해주는건 정말 기적인 듯.	내가 좋아하는 사람이 날 좋아해주는건 정말 기적인 듯.	0
내가 힘든 이유	내려놓기	1
짝녀한테 연락해볼까?	짝녀한테 연락해볼까?	0
남자친구가 비꽈	남자친구가 자꾸 빈정거려	0
겁난다	겁난다	0
비 오기 시작하네	비 오네	0
현재를 즐기면서 살고 싶다.	행복이 별건가. 즐기며 살고 싶어	0
중2병 이라더니 진짜 속썩일 줄이야	중2 아들 때매 고민이야	0
2년여의 만남	2년 동안 사궜어	0
의욕이 일도 없어	의욕이 없어	0
혈액형이 성격이랑 무슨 상관이지	혈액형이 성격이랑 무슨 상관이지	0
거지 같이 일해 놓고 갔어	일을 거지같이해	0
짝녀가 있는데 내게 연애는 사치인거같아.	짝녀가 있는데 내게 연애는 사치인거같아.	0
혼자가 되면 견디기 힘듭니다.	화장실!!	1
나한테만 잘해주는 걸까?	나한테만 잘해주는 걸까?	0
생각의 변화	생리통 때문에 배 아파	1
좋아하는 여자 때문에 너무 심각해요.	좋아하는 애한테 영화보자 하면 효과적일까?	1
오랫동안 연애 안한 사람이랑 사귀는 거 괜찮아?	오랫동안 연애 안한 사람이랑 사귀는 거 괜찮아?	0
로또 당첨 좀 됐으면	로또 좀 됐으면	0
제주도 놀러 가고 싶어요. 	제주도 가고 싶다. 	0
아닌 척 하면서 나 싫어해	티 안 나게 나 싫어해	0
짝녀가 너무 이뻐서 찝적대는 사람이 너무 많아.	짝녀가 너무 이뻐서 찝적대는 사람이 너무 많아.	0
회사에서 인정받는 방법	나 회사에서 인정받고 싶어	0
힘들까	힘듭니다 오늘 또 무너졌어	1
여자는 호감 없어도 잘해줘?	착한 사람은 호감 없어도 잘해 줘?	0
빠떼리 나감	핸드폰 배터리 나감	0
돈 빌려줬는데 연락 두절	돈 빌려줬는데 잠수탔어	0
썸 타는 거 좋아해?	너 썸 타는 거 좋아해?	0
이 상황에서 벗어나고 싶어	벗어나고 싶어	0
머리 하나도 안 남을 것 같아	이러다 대머리 되겠어	0
결국 놓아줬네	결국 또 무너졌습니다.	1
선택이 어려워.	항상 선택할 때 힘들어	0
죽을거 같네	중2 히스테리 알아?	1
기숙사 안됐어	기숙사 떨어졌어	0
짝녀가 학교에서 소문이 안 좋아.	짝녀가 학교에서 소문이 안 좋아.	0
공부 꼭 해야할까	왜 공부해야하는지 모르겠어	0
경차사랑카드	21살의 사랑이란감정	1
기분 참 더럽네	기억을 지우고 싶네	1
그는 내가 좋아하는 마음을 이용하는 걸까?	내 마음을 이용하는 걸까?	0
그리움만은 어쩔수 없는가보다	그만 힘들어하구 싶다	1
모르는 사람들이 페친 신청해	생판 모르는 사람이 아는척해	0
하루하루 이별하는 기분	하이고 숨막힌다	1
썸남도 내 생각할까?	썸남도 지금 내 생각할까?	0
너무 사랑하는데 동거해도될까?	동거해도될까?	0
썸 끝내는게 맞을까?	썸 끝내야 할까?	0
나 정말 무뎌지고있나봐	나는 괜찮다!!	1
짝남 일년 째 멀리서 지켜보기만 하는 중.	짝남 일년 째 멀리서 지켜보기만 하는 중.	0
핸드폰 중독인가봐	나 스마트폰 중독인가봐	0
나한테 왜 그러지	정말 나한테만 왜 그러냐고	0
찜질방 같이 가면 화장 지워야 할까	찜질방 가면 쌩얼 보여줘야 되나	0
감정 조절이 안돼	갑자기 밀려오는 우울감	1
교양수업이 재미있어	교양수업 은근 재미져	0
군대가기 전인데 썸녀한테 고백해도 될까	귀찮으면 썸 끝인가	1
썸 타는 사이에 얼마나 간섭 가능?	썸 타는 사이에 마무리 어떻게 해?	1
난 진짜 쓰레기야	난 쓰레기야	0
친한 친구가 결혼을한다더군	친구가 청첩장 보냈어	0
알바구함	알바하고 싶어	0
자주 가는 카페 알바생이 나를 자주 뻔히 쳐다보는데 이거 그린라이트일까?	카페 알바생이 뻔히 쳐다보는데 그린라이트일까?	0
연금 받을 수 있을까	연금 믿어도 될까	0
아직도 널 감싸는 내가 싫다.	아직도 잊지 못하는 사람	1
벌써 허기진다	허기져	0
헤어진건가이거?	헤어진 후.	1
알아들은 척했는데 모르겠어	못 알아들었어	0
이별하신분들	이별한지 2달 다 되어갑니다.	1
책장에 책이 쌓여 있어.	책장도 어지럽고 마음도 어지럽고.	0
아이디 생각 안나	셀프웨딩이 유행이래	1
조모임 왜 이케 많아	조별 발표 왜 이렇게 많이 시키지	0
동거 8년 환승이별.	두 번째 이별 이야기	1
말하는 대로 다 되면 정말 좋겠다	말하는대로 다 됐으면 좋겠다	0
여자는 좋아하는 남자랑 눈 마주치면 어때?	여자는 좋아하는 남자랑 눈 마주치면 어때?	0
15년만에 쓰는 편지.	1년4개월의 종지부를 찍네.	1
어떤 사람이랑 사랑하고 싶어?	어떤 사람이랑 사랑하면 행복할까?	0
집안일 너무 많다.	집안일 해도해도 끝이 없어	0
취업 해도 힘들고 안해도 힘들것 같아	방 밖은 위험해	1
무거운 마음이네ㅎ	무모한 시작.	1
좋아하는 애랑 같은 반 됐어	좋아하는 애랑 같은 반 됐어	0
재택근무가 더 힘든 거 같아	재택근무 힘들다	0
종교가 다르면 헤어져야 하나?	종교가 다른 여자친구 헤어져야하나?	0
살이 안빠져	살 좀 빼고 싶다	0
저 좀 웃게 해주세요	나 웃겨줘	0
스튜디오 촬영하는 날이야!	스튜디오 촬영하는 날이야!	0
떡볶이 만들어 먹었어	예쁘게 표현을 못하겠어	1
아 혼자있는게 너무 무섭네	아따 엿먹일 방법 없나	1
공감과 배려가 필요해	헤어졌는데 친구 가능?	0
여행지 추천	여행 어디가지	0
운동 매일러 가기 힘들다	운동 매일하기 힘들다	0
짜여진 시간표대로 움직이고 있어	시간표대로 움직여	0
유학간다네	음악 들으면서 잊으려고	1
순수하게좋아했지만 걔는 너무도 약은애였어	술마시고 있네	1
익숙함에 속지말자 라는말에 대하여	인연이었다던 그사람	1
술, 담배, 친구 좋아하는 사람 어떻게 생각하나요.	술, 담배, 친구 좋아하는 사람 어때? 휴.	0
저녁 메뉴 뭐 먹을까	저녁으로 뭐 먹을까	0
배부르고 졸려	배부르니 졸리다	0
알바 하나 더 구해야겠어	투잡할까?	0
헤어진지 한 달 됐어	헤어진지 한달 조금 넘었어	1
사랑의 끝은 결혼일까?	사랑하면 결혼해야 돼?	0
주말이 행복해	주말이 행복해	0
도시락 싸서 놀러 가고 싶어	도시락 싸서 피크닉 가고 싶어	0
요즘 좋아하는 남자애가 꿈에 나오는데.	요즘 좋아하는 남자애가 꿈에 나오는데.	0
나도 인정받는 사람이 되고 싶어	인정 받고 싶어.	0
썸 고백해도 될까	썸인거 같은데 고백해도 될까	0
결혼해도 될까	내가 그사람이랑 진짜 결혼해도 될까	0
일이 또 쌓이네	해야할 일들이 너무 많아	0
그동안 잘 지냈나요?	잘 지냈어?	0
썸남 생일 때 편지 줘도 될까	썸남 생일 때 편지 줘도 될까	0
포기하니 공허하네.	핑계	1
즐건 여행되길 바라고 있어	부산 가보고 싶다.	1
오늘도 하루 버텻구나.	오늘따라 더 생각나	1
여사친 좋아하는 내가 짜증남.	여사친 좋아하는 내가 짜증남.	0
흐음 이거 고민이네	흠	1
카풀로 출퇴근 해볼까	카풀해볼까?	0
남자친구가 첫사랑이야	지금 남자친구가 첫사랑이야	0
여름에는 냉면만한게 없는 듯	여름에는 냉면이지	0
양궁카페 갔다옴	양궁카페 갔다옴	0
이젠 진짜 끝인가봐	이혼만은 막고싶은데	1
철이 너무 일찍 들었어	너무 빨리 철 들었어	0
짝녀가 다른반인데 친해지는 방법없을까?	짝녀가 다른반인데 친해지는 방법없을까?	0
여르름 또났어	여드름 때매 스트레스받아	0
새신발 신고 놀러 가야지	새신발 신고 좋은 곳 가야지	1
부모님 선물 추천.	부모님 선물 추천해줘	0
시간표 망했다.	시간표 개판	0
나 새 옷 샀다	새 옷 샀다	0
가슴이 뛰어	가끔 짝사랑 하는 여자애랑 데이트 하는 상상을 해.	1
오래 연애해서 그런가 관심이 줄었어	오늘부로 짝녀를 보내기로 했어요.	1
딸기가 너무 먹고 싶어.	딸기 먹고 싶다.	0
좋아하는 애랑 연락 중인데 어떤 얘기를 이끌어가야할지 모르겠어.	좋아하는 애랑 무슨 얘기할까?	0
자기애가 너무 떨어졌어	자존감이 너무 떨어졌어	0
새벽에 눈을 뜨게 돼	새벽에 그만 깨고싶어	0
자꾸 비비꼬는데	비꼬는 사람	0
참 너랑은 악연이니??	참 아이러니 하네	1
점점 괜찮아 지는것 같다가도.	정리되지 못한 이별	1
쓸쓸한 밤시간	고독한 밤	0
날이 꿀꾸리	남은건 너의 빈자리	1
전부다 알고 있을까?	다 알고 있을까?	0
음.반복이냐	의미부여 안하고 싶은데	1
우리 학과 어떤 애 쫌 훈훈하다	우리 과에 좋아하는 애 있어	0
좋아하는 사람이 쓰레기면 어떻게 할꺼야?	좋아하는 사람이 인기는 많은데 여친이 없어. 왜 그럴까?	1
짝녀 관련돼서 악몽을 자주 꾸는데 불안함.	짝녀 관련돼서 악몽을 자주 꾸는데 불안함.	0
통화할 사람이 한 명도 없어	전화할 사람이 없네	0
좋아하는 감정을 혼자서 정리할 수 있을까요?	좋아하는 감정을 혼자서 정리할 수 있을까요?	0
먹는거에 너무 예민한 여자친구가 고민임.	먹는거에 까다로운 여자친구가 고민임.	0
마음을 들켰나봐	내 마음을 들켰나봐	0
돈 좀 모아야 할텐데	돈 모으고 싶어	0
단수	물이 안 나와	0
헤어진 남친 지나고 생각해도 잘 한 듯	전 남자친구랑 헤어지기 잘한 거 같아	0
막차 놓쳤어	버스 끊겼다	0
썸 타는 것 같은데 조언해줘.	썸 타는 것 같은데 조언 좀.	0
저만 힘든 것 같아요	전 병신인가봅니다.	1
연애 안 한지 너무 오래 됐어	너무 오래 연애 안했어	0
성격적으로 안맞는걸 알지만 마음은 그게 아님을 알땐	세상에서 제일 이뻣던 내 전 여자친구에게	1
여자들이 좋아하는 남자들 특징 알려 줘	여자들이 좋아하는 남자들 특징이 뭐임?	0
기분이 더러워	기분이 그지 같아	0
땀이 너무 많이 나는 날씨	더워서 땀나	0
종이에 손 베였어	손 베였어	0
AB형 남자랑 썸 타면	AB형 여자랑 썸 타면	1
손님 싫어	손님 오는 거 싫어	0
내가 나빴네	내가 그르친 거 같아	0
많이 좋아했었는데 이젠 정리하려고.	좋아했었는데 이젠 맘 정리하려고.	0
사랑한다는 내용이 들어간 노래 제목	사랑하는데 어떻게 해야 할지 문의드립니다	1
치과 가면 돈 많아 들텐데	치과 가면 돈 엄청 깨질 텐데	0
짝녀 프사 자음이 궁금함.	짝녀 프사 자음이 궁금함.	0
나 어떡하나	나 혼자 잡고 있던 끈이었어	1
짝사랑 하는 여자가 있는데 말을 못하겠어	짝사랑 하는 여자 앞에서 아무 말도 못해	0
집착하는 것 처럼 보이면 어떡해?	집착하는 것 처럼 보이면 어떡해?	0
여자친구의 sns말투가 고민이야.	여자친구의 말투가 고민이야.	0
오토바이 있었으면 좋겠다	오토바이 사고 싶어	0
한사람어게추억이된다는것	한숨만 나오네.	1
친구 짝녀가 날 좋아하는데 어쩔.	친구 짝남이 나 좋아하는데 어떡함.	0
카톡에 차단시	커플링 사진 그대로 두나?	1
드론 조종사 자격증 따면 재밌을 거 같아	드론 자격증 딸까?	0
자괴감	자꾸 다시 만나게 되는데 무슨 방법이 좋을까	1
패턴 아는데 풀어봐도 될까?	패턴 아는데 핸드폰 문자 봐도 될까?	1
안뇽	안녕	0
여자친구가 기념일을 잘 잊어.	여자친구가 기념일을 잘 잊어.	0
헤어진지 3달만에 새로운 남자가 생긴 그녀.	헤어진지 3주째	1
마주칠까?	마지막 문자 보냈어	1
심심아 심심하다	심심해	0
짝남이 날 좋아하게 할 방법이 있을까?	짝남이 날 좋아하게 할 방법이 있을까?	0
짝사랑 하는 사람이 날 좋아할 확률은?	짝사랑 하는 사람이 날 좋아할 확률은?	0
냉장고가 텅비었어	냉장고에 먹을 게 없네	0
한거도 없는데 벌써 이시간	시간 잘 간다	0
급 내 짝남 생각나는 일화가.	갑자기 짝남 생각나는 일화가.	0
베터리 겨우 15%야	베터리 15%야	0
엄마 보고 싶은데 전화할까	나 오늘 유난히 엄마 보고 싶다.	0
이거저거 막 사고 싶어.	막 뭐 사고 싶어.	0
크리스마스인데 만나자고 해도 됨?	크리스마스인데 만나자고 해도 됨?	0
썸 타는데 적극적으로 해도 됨?	썸 타는데 적극적인 사람 괜찮을까	0
짝사랑하는 남자가 생겼어.	짝남이 생겨버렸어.	0
나한테 잘해주는데 썸일까?	잘해주는데 썸일까?	0
클럽에서 여자친구 찾아볼까?	클럽에서 만나서 사귀는거 어떻게 생각해?	0
어제 짝남한테 너무 차갑게 말한 것 같아.	어제 짝남한테 너무 차갑게 말한 것 같아.	0
샆 좀 빠졌으면	몸무게 좀 줄었으면	0
시간은 눈물과 흐르고	시간이 약이라는데 독이 되는거 같습니다.	1
이혼을 앞둔 부부밥상	인과응보, 속이 다 시원해	1
썸 타다 지쳤어	썸 타다 지쳤어	0
두 남자 사이에서 갈등 중	두 남자 사이에서 마음을 못 정하겠어	0
사랑은 변하지 않았으면	사랑이 어떻게 변해	1
메뉴얼이 있으면 뭐하나	메뉴얼이 있으면 뭐해	0
스키 첨 타 봤어.	스키 처음 타 봐!	0
학원에 좋아하는 여자애가 있는데 말 거는 방법 좀.	학원에 여자애가 있는데 말 거는 방법 좀.	0
썸은 어떻게 타는거야	썸은 어떻게 타는거야	0
몇시간 동안 안와	날 몇시간동안이나 기다리게했어	0
죽고 못 사는 관계	죽고 못 사는 관계	0
자꾸 갠톡하는 선배 있는데 관심 있나?	갠톡하는 선배 있는데 관심 있나?	0
고마워	알려 줘서 고마워	0
남자친구가 너무 국밥류만 좋아해.	남자친구가 맨날 국밥만 먹어.	0
여자친구에게 팔찌 목걸이 둘중하나만 선물할 수 있다면 뭐가 좋을까?	여자친구 선물 팔찌랑 목걸이 중에 뭐가 좋을까?	0
짝녀한테 카페 가서 같이 공부하자고 해볼까?	짝녀한테 카페 가서 같이 공부하자고 해볼까?	0
죽진 못하겠구 겁이나고	지겹다	1
나 윗집 남자애 좋아하는 것 같애.	윗집 남자애 괜찮은 애 같아	0
서류에서 탈락	서류에서 불합격	0
아빠가 술 좀 끊었으면	아빠가 술 좀 그만 먹었으면	0
헤어진지 한 달 조금 넘었는데 여전히 힘드네	헤어진지 한달.	1
노래가 정말 가슴이 찢어지내	누구나 궁금할법한 이야기	1
남자친구가 집안일을 너무 안해. 나만 하는게 고민이야.	남자친구가 집안일을 너무 안해.	0
아무도 없어	혼자가 편해	0
짝남이 운동하다 다쳤는데 어떡하지?	짝남이 운동하다 다쳤는데 어떡하지?	0
얼굴 평가해 달래	얼평해달라는 사람 어떻게 생각해?	0
향수 뭐로 할까	무슨 향수가 좋을까	0
나도 약초 캐볼까?	약초 캐볼까?	0
계속 속이 진짜 안 좋아	요즘 속이 안 좋아	0
썸남 있는데 완전 스윗함.	썸남 있는데 완전 스윗함.	0
돈이 없어졌어.	돈 잃어버렸어	0
썸은 꼭 타야 해?	썸 좀 타다가 연애로 가는 건가?	1
발톱 손질 받을까	패디나 할까	0
절 찼던 남자애가 다시 절 좋아하는게 가능할까요?	전부 다 줘도 아깝지 않은 사람	1
좋아하던 여자애가 남친 생겼다는대 아무렇지도 않아.	좋아하던 남자애가 여친 생겼는데 막상 아무런 느낌 안 들어.	0
신발 선물 받았어	새 신발 선물 받았다	0
힘든 일이 너무 많아요	괜찮아 천천히 해도 돼	1
이젠 제 자신한테 지칩니다	이젠정말끝이네	1
내 주제를 모르고 덤빈건가	내가 주제를 몰랐던 거지	0
나랑 썸 타는 줄 알았는데 내 동기랑 사귐.	나랑 썸 타던 여자애가 내 친구랑 사귄대	0
썸 타니까 연락에 집착하게 돼.	아직 썸이라서 연락에 집착하게 돼.	0
스트레스 팍팍	스트레스 만땅	0
못참고 카톡 보내버렸네	참지 못하고 카톡했어	0
밤은 길기만 하죠.	방법이 없는걸까?	1
우리 둘이 모은 돈으로 결혼해야 돼	우리 둘이 모은 돈으로 결혼해야 돼	0
영화관 알바하면 좋겠다.	영화관 알바 하고 싶다	0
사랑꾼	하 사랑꾼이구만	0
너에게 보낼 수 없어 여기다 남길게	너와 처음 만났던 공간부터.	1
택배 기다리고 있어	택배 왔나 궁금하다	1
좋아하는 남자 생겼는데 호감 어떻게 표시할까요.	좋아하는 남자애가 담배를 피는데 어떻게 끊으라고 말해볼까요?	1
한 잔 하고 싶다	술 마시고 싶다	0
스키장 간다!	주말에 스키장 간다!	0
점점 좋아져	얼굴은 내 스타일 아닌데 점점 좋아지는 거 같아	0
이기적인 마음	이러면 안되는데	1
서로 좋아하는 것 같은데 내가 자존심 때문에 자꾸 관심 없는 척하게 돼.	자존심 때문에 자꾸 관심 없는 척하게 돼.	0
마음 열기가 어려워	마음을 모르겠어	1
뷔페 가고 싶어	딸기 뷔페 가고 싶어	1
내 실력 좀 쩌는 듯	나 좀 쩌는 듯	0
힘든데 밉지가 않아	힘들어 미치겠습니다	0
좋아하는 선배가 있는데 선톡오게 하는 방법 좀.	좋아하는 선배가 있는데 선톡오게 하는 방법 좀.	0
쉽게 상처받는 거 같아	말이 제일 무서운 듯	0
그냥 이렇게 산다.	그냥 행복하면 그뿐	1
연애 상대와 결혼 상대는 다를까?	연애 상대와 결혼 상대 달라?	0
팩해야지	팩이나 할까	0
머리 염색 해야지	염색이나 해야지	0
썸인데 행동은 완전 커플처럼 해	아지구썸인데 행동은 커플	0
여자친구 붙잡느라고 모든걸 쏟아붓고 있습니다	여자친구와 헤어진지 어느덧 6개월이네,,	1
이별후	이별후 8개월이란 시간이 흐르고	1
내가 나쁜놈인가.	내가 멍청한건가	1
친척들 만나는 거 불편해	친척 대하는 거 불편해	0
다시 붙잡는 사람.	다시 원점으로 돌아온건지.	1
갈까 말까 고민 돼	갈까 말까?	0
왜 교양도 들어야 해	전공만 듣고 싶다	0
버스 정류장에서 기다리고 있었어.	버스 정류장에서 기다리던 사람	0
인테리어 좀 다시 해야할 듯	리모델링할까	0
약 챙겨 먹어야지	약 먹고 나아야지	0
모르겠어	몸에서 멀어지면 맘에서도 멀어진다는데.	1
헤어지고 만나고 를 반복하다가 다시 만났는데	헤어지고 자꾸 생각나	1
이별 성장통이 너무 길다.	이별 이야기는 신중해야 하는걸 아니까 오늘도 고민합니다	1
썸 지났는데 고백 안하면?	썸 지났는데 고백 안하면?	0
미치겠습니다	미친 사랑을 했습니다.	1
남친이 데이트 시간을 자꾸 늦어.	남친이 약속 시간을 자꾸 늦어.	0
할 말이 없다.	뭐라고 할 말이 없네	0
좀 맞자	죽을래?	0
썸인가요	썸인가요	0
짧은 연애였는데 더 힘드네.	쩝 전여친이랑 통화 한 번하니 좀 낫네	1
과거에 얽매여 있어	괜찮다 나는 괜찮다	1
고민이 많은데 표현을 못하겠어	고민을 어떻게 표현하지	0
부산 갈까?	부산 놀러갈까?	0
저 사람이 왜 자꾸 볼까?	저는 전 여친 관련해서 거의 모든걸 다 지웠어	1
풋풋한 사랑 하고 싶어.	풋풋한 사랑 하고 싶어.	0
어떤 마음인걸까	어떻게 하면좋을까	1
심심한데 뭐 재미있는거 없을까	심심하다고	0
술 취해서 지갑 잃어버렸어	술 먹고 지갑 잃어버렸어	0
할줄 아는거 	뭐 할줄 알아	0
긴장 푸는 법 알려줘	긴장돼	0
걷자고 꼬셔	게임 아이템 지르는 남친	1
다들 우리 잘 어울린대	더 사랑해달라고 말해볼까	1
썸을 오래 탔는데 사귀어도 괜찮은 사람일까?	썸을 오래 탔는데 사귀어도 괜찮겠지?	0
일이랑 공부 병행 가능?	일하면서 공부할 수 있을까?	0
내가 첫사랑이래	내가 첫 연애래	0
속이 안 좋아	속이 계속 안 좋아	0
새치가 왜 이렇게 많을까	새치가 왜 이렇게 많이 나지?	0
카페에서 같이 알바하는 사람이 좋아졌어요.	카페 알바생이 좋아졌는데 들이대도 괜찮을까?	1
크리스마스 다음날 이별했습니다.	퇴근길에 봤네	1
여행지에서 마음에 드는 사람 만났어	여행 와서 맘에 드는 사람 만났어	0
남자친구랑 멀리 떨어져야할 거 같은데 어쩌지?	남자친구의 과거의 동거를 이해해줄 수 있어?	1
여린 마음에 상처준 건 아닐까?	여린 마음에 상처준 건 아닐까?	0
핸드폰 없을 때는 어떻게 살았냐?	핸드폰 너무 많이 해	0
남자친구가 나를 떠날까봐 고민이야.	남자친구가 떠날까봐 고민이야.	0
이별 한달인데 가슴이 답답한게 아직도	이별 후 그사람과 마주치는 거	1
처음 보는 사람이랑 뭔 말을 하지	처음 보는 애랑 무슨 얘기하지	0
재회했다가 이별 .	저는 개인적으로 따로 연락하자는분들.	1
내가 좋아하는 거 모르나	내가 좋아하는 거 모르는 거 같애	0
사랑이 뭘까?	사랑하던 그 사람.	1
시선이 자꾸 느껴져	다른 사람의 시선이 너무 신경쓰여	0
썸에서 연애로 못넘가요	썸에서 연애로 넘어갔어요	0
싫어졌다가 좋아지는 경우도 있나요?	싫어졌다가 좋아지는 경우도 있나요?	0
오토바이 타러 가고 싶다.	오토바이 타고 싶다	0
빵 한 개만 먹어야지	빵 먹어야지	0
소개팅남 연락이 없어	소개팅하고 연락이 안 와	0
잘못한게 돼버렸어	다 내 잘못이지	0
너무 힘든데 조언 좀	너무 힘들어서 정말 너무 힘들어	1
권태기라고 이별을 통보하는 사람	그 사람에게 여자가 생겼네. .	1
이별준비 하려고	이별하고 욕했어	1
그는 내가 좋아하는 이 상황을 즐기는 것 같아.	내가 좋아하는거 즐기는 것 같아.	0
잠 잘못 잤나봐	잠을 잘못 잤나	0
난방이 안돼나 추워	난방이 안돼	0
기회를 놓쳤어	기회를 못 잡았어	0
여친이 나를 좋아하는게 맞는지 모르겠음.	이게 맞는지 모르겠음.	1
집이 더러워	집이 너무 지저분해	0
왜 이런 일이 일어날까	나한테만 왜 이런 일이 일어날까	0
짝녀랑 얼굴 마주보고 대화할 때 미칠 것 같아.	짝녀랑 얼굴 마주보고 대화할 때 미칠 것 같아.	0
모태솔로인데 어떻게 시작해?	연애 처음인데 어떻게 시작해?	0
짝남이 갑자기 못나 보여.	짝남이 갑자기 못나 보여.	0
여자친구 보고만 있어도 좋아	여자친구 좋아	0
세상 참 모르는 일이네	소개팅 거절도 힘든거네.	1
연락 계속 오면 관심 있는 거야?	연락 문제로 지쳐가	1
신혼여행 가서 돌아오기 싫다	아무도 안 놀아줘	1
쓸쓸하다	고독한 밤	0
나 편안해질까?	나는 더 이상 아닌거겠져.	1
잠시라도 좋으니 만낳 수 있을까	장가간 그사람	1
오늘 따라 보고 싶네	오늘 따라 더 보고 싶네	0
헤어진 여친 생각나	전여친 보고 싶어	0
점심시간 너무 짧아	점심시간 너무 짧아	0
2년간 연애 끝에 헤어집니다	2년만에 연락을 했습니다.	1
또 한번의 무너짐	또다시 찾아오는 밤	1
나를 사랑해줄 사람 언제 나타날까	조금 더 노력할걸	1
나만 왜 이렇게 사랑이 힘들까	나이 차이 많이 나는 여자 어때?	1
열받아서 소주 한 잔 해야할 듯	한강에서 소주 마시는 중	1
상견례 날짜 잡아야되는데	상견례 하자고 하시네	1
이틀전 그녀에게 연락이 왔습니다	이혼한지 일년이 넘었네	1
헉	어머나	0
사귀던 사람이 갑자기 연락이 안돼	사귀던 사람이 갑자기 연락이 안돼	0
헤어졌는데 계속 연락중	헤어졌습니다 이제 어떡하면 되나?	1
이별. 무뎌짐	이별.그리고 노래	1
내가 만난 최악의 여자	내가 얼마나 찾아야 할까.	1
보고싶다는 생각이 너무 간절하네	보고 싶은데	0
영원한 사랑이 되길	영원한 사랑 하고 싶다.	0
썸 깨지고	썸만 타다가 깨졌어	0
데이트로 놀이공원 가는거 어때?	놀이공원 데이트 어때?	0
짝녀가 나한테 먼저 연락올 일은 없겠지?	짝녀가 나한테 먼저 연락올 일은 없겠지?	0
아직도 좋아하는 사람이 있는데.	혼자 좋아하는 이야기 들어볼래요?	1
예랑이가 마마보이인듯	예비 신랑이 마마보이같아 걱정이야	0
누군가를 좋아하는게 이렇게 힘들줄 알았다면 시작도 안했을거야.	누군가를 좋아하는게 이렇게 힘들줄 알았다면 시작도 안했을거야.	0
발목 접질렀어	발목 다쳤어	0
여자인데 먼저 대쉬해도 됨?	여자인데 먼저 대쉬해도 됨?	0
좋아하는 사람한테 고백 안하는 사람도 있나요?	좋아하는 사람한테 만나자고 말해도 되나.	1
이별 2일째.	이별 6개월후	1
헤어진지 4일째 네	헤어진지 9일	1
한달의 시간을 갖자고 했지만 이별의 수순일 뿐인것 같네	한달째 클럽에서 죽치고 있을뿐	1
이사 도와줘야 할까	이사하는 거 도와줄까	0
안경 벗으니까 완전 예뻤어	안경 벗고 완전 훈녀	0
막말 쩔어	막말 좀 안 했으면 좋겠다	0
날 사랑하는 이유가 뭘까?	남사친이 남자로 느껴질때 있어?	1
남자친구가 마중 나온대	남친이 나 마중 나온대 헤헤	0
썸 타는 여자애 상메 궁금해.	후회없이 사랑하고 싶어	1
걔는 싸우면 연락이 안돼	싸우면 잠수하는거 짜증나.	0
싸우면 어떻게 해결해?	싸우면 보통 어떻게 해결해?	0
햇볕이 너무 좋다	오늘 햇볕 좋다	0
매번 글쓸때마다 상황설명하라고 해	매일 계속되는 악몽과 불면증	1
차가워	손발 시려	0
졸업 사진 잘 못 찍었어	졸업 사진 망했다	0
끝까지 절 갖고 놀더군	끝내는게 맞을까	1
위장에 탈 난 거 같아	위병 난 거 같아	0
이렇게 갈 거였구나	그렇게 갈 거면서	0
짝녀한테 의미 없는 선톡 해도 될까요?	짝녀한테 의미 없는 선톡 해도 될까요?	0
평범함 속에 웃음 속에 감쳐진 나	폰 자꾸 보게 돼	1
할 줄 아는거	너 또 뭐할 줄 알아?	0
이불 밖은 위험해	집 밖에 나가기 싫어	0
연락 못하는 아픔.	연락을 하면 안되는구나	1
여자친구와 커플링 꼭 해야함?	커플링 꼭 해야 함?	0
짝남 있는데 소개 들어오면 받나요?	짝남 있는데 소개 들어오면 받나요?	0
사랑없이 결혼한 케이스 있어?	사랑타령 그만하고 결혼하고 싶다.	1
김치찌개 먹어야겠다.	점심에 김치찌개 먹어야지	0
사랑하면 뭐가 달라져?	사랑하면 사람이 바껴?	0
자고 일어났더니 하루 다갔어.	잠만 잤네	0
아무것도 아닌 일이 될 수 있을까	아무리 매달려도	1
수염 자르지 말까	수염 기를까	0
마음을 못열겠어요 	면접을 봤는데 마음에 드는 사람이 없었나봐	1
못하는거 투성이야	못하는게 너무 많아	0
썸 타던 남자가 답장이 안와	썸 타던 남자가 카톡이 안와	0
앞으로 조심해야겠다.	조심조심	0
우정이 뭘까	우정이 뭐야?	0
내 여자하자.	내가 사랑해도 될까?	1
잘 할 수 있을지 걱정 돼	잘 할 수 있을까?	0
직장에서 상사가 괴롭혀.	상사가 갈궈.	0
농사 짓고 살까?	귀농 어때?	0
인연이란게 있을까?	인연이 있다고 생각해?	0
손톱이나 깎아야지	손톱에 예쁘게 칠해야지	1
뭔가 무력해	무력하고 피곤해.	0
아파	아파서 어떡해	0
여자친구한테 더 이상 설레지 않아	여자친구한테 더 이상 설레지 않아	0
이별후 네달째	이별후 재회 그리고	1
이별 후 6달째. 이제 그만좀 잊고 싶어	이별 후 두달 경과보고서	1
한폭의 그림 같은 우리	한폭의 그림 같이 예쁘게 사랑하고 싶다.	1
니 물건들 잡동사니들다 버려달라고 부탁했는데	니가 원망스러워	1
정말 모든게 그립지만.	정말 사람이란	1
남자친구가 변해가는거 같아.	남자친구가 너무 변해가는거 같아.	0
목표가 없어	목표가 없어서 걱정임	0
헤어지고 나서 알았어 사랑했다는 걸	헤어지고 나서 사랑했다는 걸 알았어	0
짝남은 짝남일 뿐인가.	짝남은 짝남일 뿐인가.	0
변한게 하나도 없어	변한게 없어	0
사랑하는데 여자친구가 너무 이기적이야.	여자친구가 너무 이기적이야.	0
이제야 깨달음	이젠 놓아주려 해	1
이별을 기다기는건지 아닌지	이별을 빨리 인정해야 하는데.	1
한달 만에 보는 너에게	한달째	1
의욕이 안 생겨	의욕이 없어	0
에혀 힘드네여	여기 글들을 보니깐	1
조언 듣고 싶다.	인생에 정답이 있나?	1
짝사랑한 만큼 상처도 깊어져.	짝사랑한 만큼 상처도 깊어져.	0
몰래 sns 훔쳐보고 있는 나 한심해	몸이 아프니깐 더 힘드네	1
오늘 화장 좀 잘된다	부모님이 허락 안해주셔	1
길에서 번호 따였어	길에서 헌팅 당했어	0
남자친구가 진짜 잘 챙겨줘	남자친구가 잘 챙겨줘서 고마워	0
누가 문열다 내차 긁었어	문콕당했어	0
어떻게 하면 좋을까.	어떻게!	0
눈썹이 귀여워	눈썹이 씰룩씰룩	0
세금 너무 많아	세금 너무 많이 내는 거 같애	0
카톡하고 싶고 자꾸 생각나고 그러면 좋아하는 건가?	카톡하고 싶고 자꾸 생각나고 그러면 좋아하는 건가?	0
친구들이랑 셀프 이사	친구가 이사하는 거 도와준대	0
단둘이 놀자	데이트 할때 너무 많이 먹는 남자친구가 고민이야.	1
행복해야 돼	허허 모든 것을 다 줬는데	1
나쁜 꿈 꿨어	악몽 꿨어	0
너무 많은 걸 바래	나한테 너무 많은 걸 바라는 듯	0
바나나 먹고 싶다.	바나나 먹어야지	0
임용 결과 발표 기다리고 있어	임용 기다리고 있어	0
안 데려다 줬어	데려다 주지도 않고	0
발레 배우려고	발레 배워보려고	0
나를 좋아하는데 숨기는 사람한테 나도 좋아한다고 어떻게 표현해?	좋아한다고 말 못하는 사람에게 나도 좋고 어떻게 말해?	0
쉬운 것만 하고 싶다.	주위에 잘하는 사람 너무 많아	1
조금만 더 참을껄	조언 부탁드립니다	1
충전해야겠다	핸드폰 충전해야지	0
내 강점은 어떤걸까?	내가 더 잘하는 건 뭘까	0
챙길게 너무 많아	하나부터 열까지 챙길게 너무 많아	0
정말 사랑했어	맘 속 깊이 사랑했는데	0
좋아하는 사람한테 집까지 데려달라고 부탁해볼까?	좋아하는 사람한테 집까지 데려달라고 부탁해볼까?	0
매년 좋아하는 애가 바뀌었는데 어떡하죠.	좋아하는 애가 매년 바뀌는데 어떡하죠.	0
불타올랐다가 식었어	너무 좋았는데 이제 식었나봐	0
나 잘하고 있는 걸까?	나 잘하고 있는 건지 모르겠어	0
썸 타는 중인데 나 말고 다른 사람하고도 썸타는 것 같아.	나 말고 다른 사람하고도 썸타는 것 같아.	0
사랑하는 사람 만나서 행복해	결혼 약속할 만한 사람 만나서 다행이다	1
듬직한 사람이 좋아	기댈 수 있는 사람	0
늦게 까지 술 먹나 보다	술만 먹으면 집에 늦게 와	0
자신감 업되는 비결 좀	자신감을 갖고 싶어	0
사랑이 뭐길래	사랑이 뭐길래 이렇게 힘들게 하지	0
첫 데이트에 뭐 먹는걸 좋을까?	첫 데이트에 뭐 먹는걸 좋을까?	0
짝사랑 하면 무슨 기분인지 알긴 해요?	짝사랑 하면 무슨 기분인지 알긴 해요?	0
짝남 보란듯이 잊어주겠어.	짝남 못 잊겠어.	1
화장이 안 받네	화장이 안 먹네	0
돈 없어 투잡이라도 해야할까 	투잡 뛰어야 하나?	0
사랑하면 마냥 좋은 건 아닌 거 같아	사랑한다고 다 좋은 건 아닌 거 같아	0
섬유유연제 향 좋은거 사야겠지	섬유유연제 향 좋다	0
대부분 무덤덤한 남자친구가 고민임.	데이트중에 정적 있어도 괜찮을까?	1
애들 총회에 왜 나를 오라고 하냐	애들 총회 가야겠죠?	0
효율적으로 공부하는 방법	새 해 결심 뭐였더라	1
원서 낸거 1지망에서 떨어졌어	1지망 학교 떨어졌어	0
정말.내 자신이 싫다	정말잊어보려고 모든수단을 동원했지만.	1
똑같은 나날들	요즘 너무 지루해	0
좋은 대학 나온 사람 부러워	좋은 대학 나온 거 부러워	0
참 힘드네	참다가 연락	1
여자친구가 나를 sns에 올리지 않아서 서운해.	여자친구가 나를 sns에 올리지 않아서 서운해.	0
붙잡고 싶은데 힘이 드네	비가 많이 오니까. 너가 떠오른다.	1
화장 좀 예쁘게 하고 싶다	화장 잘 하고 싶다	0
착한 사람이 잘 됐으면 좋겠어	착한 사람이 잘 됐으면 좋겠어 좀	0
연차 내고 누워만 있네	오늘 6년이란 시간을 정리했습니다.	1
약 먹었더니 졸려	약 기운에 졸음이 몰려왔어	0
걔랑 같은 반 됐으면 좋겠다	좋아하는 애랑 같은 반 됐으면 좋겠다	0
뭘 해도 재미없다.	재미없는 일밖에 없어	0
나를 좋아하는 사람이 있는데 철벽치게 돼요.	좋아해 주는 사람이 있는데 철벽치게 돼요.	0
심심해	썼다 지우고 다시 썼다가 지우고	1
방에 먼지가 한가득	먼지가 쌓였네	0
매운 국물 떡볶이 먹고 싶다	떡볶이 먹고 싶다	0
짝사랑만이 답일까.	짝사랑만이 답일까.	0
밥이 없어	집에 먹을게 없어	0
완전히 정리했어	왜 끝내지 못하는거죠?	1
왜그랬어?	외로운 지금 이 순간을 강해지고 있다는 생각으로 살고 싶다.	1
만든 사람	누가 만들었니?	0
좋아하는데 이전과 다를게 없을까봐 말을 못하겠음.	좋아하는데 이전과 다를게 없을까봐 말을 못하겠음.	0
머리에서 열날거 같다.	머리만 바빠	0
나 너무 못생겼어	이미 망하고 있는거 아닌가? 	1
남자친구가 질투하는 거 귀여워	남자친구가 질투하는 거 귀여워	0
바다에서 놀고 싶다.	오늘은 파도가 잔잔하네	1
어떤 여자가 나한테 끼 부려	어떤 여자가 나한테 끼 부려	0
여자들은 남자가 자기 좋아하는거 눈치 잘 채?	여자들은 보통 남자가 자기 좋아하는거 눈치 잘 채?	0
허리가 많이 아파	허리가 아파	0
사랑하는데 꼭 결혼해야할지는 모르겠어요	사랑하는데 결혼까지는 아직 생각 안해 봤어	0
전여자친구 잊고 사랑하는법.	전여친 헤어졌으니 남이죠?	1
만난지 이틀만에 고백받았어	만난지 이틀만에 그 사람한테 고백받았어	0
소화가 안돼	과식해서 소화가 안돼	0
인형 뽑기 돈만 날렸어	인형 뽑기 어려워	0
여자친구가 나 사랑하는 건지 모르겠어	여자친구가 나 사랑하는 건지 모르겠어	0
그녀에게 연락이 왔습니다	그녀와 헤어지고 느낀게 많네	1
쌍커풀 해볼까	쌍커풀 해볼까	0
넥타이핀 선물 괜찮겠지?	넥타이핀 정도는 선물로 줘도 괜찮겠지?	0
내일 뭐 입고 나갈까	내일 뭐 입지	0
사랑에도 유효기간이 있다는데	사랑에도 유효기간 있나요	0
내가 뭘 잘못했을까	내 잘못이 뭔지 모르겠어	0
체육복 또 까먹었어	체육복 안 가져 왔다	0
돈 벌면 뭐하나	돈 벌어서 뭐하지	0
그냥 혼자 있는게 좋아	혼자 있고 싶다	0
팔로우 왜 안해주지	SNS 맞팔 왜 안하지ㅠㅠ	0
그녀가 떠났습니다	그녀는 무슨 생각일까?ㅠ	1
후련하네여	말하고 나니 후련하네여	0
갑자기 무너져버린 내자신	갑자기 화가나서 싸우고	1
이발 어떻게 할까	머리 어떻게 깎을까?	0
이건 뭐 혼자 썸타는 기분이야.	썸타는데 나만 그런거 같아	0
나를 좋아하는 애랑 친구 가능?	사랑한다는데 친구 가능?	0
짝남에게 빼빼로 줘도 될까	짝사랑한테 빼빼로 줘도 될까	0
기프트콘으로 선물해야겠다	기프트콘 선물해볼까?	0
재회 그리고 다시 이별	재회 후 이별에는 후폭풍이 없는줄 알았는데	1
좋아하는 남자애한테 발렌타인데이 때 초콜릿 줄까?	좋아하는 마음을 감출길이 없어.	1
짝남이 오늘 야근이래. 문자 한 통 보낼까	짝남 있는데 실수했어. 챙피해	1
썸남 꿈 꿨어.	썸남 꿈 꿨어.	0
밤 12시야	12시 땡!	0
이별한지 두달이 넘고 얼굴 안본지 한달이 넘은	이별한지 한달된 남자입니다.	1
아직도 사랑하는 거 같아	나만 좋아하는 것 같아	1
햇살이 좋아요 산책 해야겠어요	오늘 산책할 날씨에요	0
발표할때 자꾸 떨려	발표할때 너무 떨려	0
썸 정리 어떤 식으로 해야 할까	썸 타는 사람이랑 마음 정리 어떤 식으로 해야 할까	0
카페 대신에 갈만한 곳?	카페 말고 갈만한 곳?	0
치맥데이	오늘은 치맥이야	0
헤어진지 한 달.아직도 힘드네	헤어진지 한달 됐어.	1
여자친구의 회사가 내가 다니는 회사랑 너무 비교돼	여자친구의 회사가 내가 다니는 회사랑 너무 비교돼	0
사랑하는 사람 사이에는 보이지 않는 끈이 있을까?	사랑하는 사람 사이에는 보이지 않는 끈다는 말 믿어?	1
전여친 최악입니다	전여친이 나보다 나은 사람이라는 생각이 자꾸 들어	1
좋아하는 것과 사랑하는 것의 차이가 있나?	사랑인지 어떻게 아나요?	1
놀아 줄 사람이 없어	눈물	1
공부하기 싫어	공부하기 싫은 날	0
첫이별후 제가 가장 충격먹었던게.음	추석연휴가 그렇게 좋지만은 않다.	1
어릴땐 누군가를 참 쉽게 좋아했는데 지금은 어려워.	어릴땐 누군가를 참 쉽게 좋아했는데 지금은 어려워.	0
연락처좀 바꿔 주라	연락해보는게 좋을까	1
엄마아빠랑 다시 같이 살아야돼	에휴	1
여사친이랑 잘되고 싶다	여사친이랑 잘되고 싶다	0
버려줘서 고마워.	벌써 6개월째라니	1
썸 중인거 이야기할까	친구한테 썸 중인거 이야기 해야하나	0
시련	싫어지는것.	1
짜증나	보기만해도 짜증이 나지	0
서로 좋아하게 되는건 운명같은 일이었어.	사랑은 운명같은 일이었어.	0
맞춤 정장 했어	맞춤 정장 샀어	0
썸이 날 싫어하는 꿈을 꿨어.	썸이 날 싫어하는 꿈을 꿨어.	0
나랑만 연락하면	나랑만 연락하면 좋겠다.	0
하루종일 맘 상한게 안풀려	하루종일 속상해	0
관절염인가	관절염 같애	0
만난지 얼마 안됐는데 고백받았어	만난지 얼마 안됐는데 벌써 고백받았어	0
휴학하고 싶다.	휴학할까	0
황당하지만 재미난 일이 생겼네ㅎㅎ	후 좀 낫네여	1
자신과의 싸움중에서 이제 이틀째 날	자존감이 떨어져 있는 지금.	1
남친 프로필에 내 사진 왜 안올릴까	남친 프사에 내 사진 없어	0
뭔 비밀이 그렇게 많은지	비밀이 너무 많은 거 같아	0
텀블러 까먹었다.	텀블러 안 가져 왔다	0
남자 여자 나이차가 어느정도 나야 적당한건가	나이차이 많이 나는 누나가 좋은데.	1
전학가게 됐어	이사가서 전학가게 됐어	0
이런 나를 좋아해주는 사람이 있을까?	이런 나를 좋아해주는 사람이 있을까?	0
몸살 났나봐	몸살 나서 힘들어	0
이 사람은 도대체	이거 참 뭐하고 있는건지	1
이별극복후 새로운 설렘	이별밖에 방법이 없을까?	1
짝사랑 하는 사람이 날 좋아할리는 없겠지?	짝사랑 하는 사람이 날 좋아할리는 없겠지?	0
위층 너무 시끄러워	층간소음때매 환장하겠어	0
친구들과의 모임이 너무 많은 사람	모임이 너무 많은 사람	0
미팅 할까 말까	미팅 할까	0
키가 크면 좋을텐데	키가 조금만 더 컸으면 좋겠어	0
천년의 짝사랑이 식는 기분.	천년의 짝사랑이 식는 기분.	0
그와 같은 조가 되고 싶은데 먼저 말해볼까?	같은 조하자고 먼저 말해볼까?	0
애프터까지 왔는데 연락이 뜸해.	애프터까지 왔는데 연락이 뜸해.	0
사귄지 5년 됐는데 아직도 좋아	5년 동안 사귔는데 사랑해	0
학교에서 아싸해도 될까?	대학에서 아싸해도 될까?	0
이제야 좀 잊혀지네	이젠 눈물이 말라버렸나 봅니다.	1
앞으로 뭐하고 살지	뭐하고 살지	0
정말 후회없고 미련없이 사랑했던 사람들!!!	정말 힘들다	1
희망이 딱히 없어	장래희망이 없어	0
여자 마음 너무 복잡해	여자 마음 알다가도 모르겠어	0
너무 잘하는 후배가 들어왔어	후배가 너무 잘해	0
7년이 지났는데 아직 가끔 소식이 궁금해~	벌써 이별한지 7개월 넘어가네	1
이별은 필수입니다	이별을 받아들여야 하는데 생각이 자꾸 나네	1
아부 잘 하는 사람 부러워	아부도 기술인가봐	0
짝남있던 단톡방에 술 마시고 실수했어.	짝남있던 단톡방에 술 마시고 실수했어.	0
남자가 더 사랑해서 한 결혼	남편이 더 사랑해서 한 결혼	0
이제 취업 해야할 텐데	취업하고 싶다	0
과거는 잊고 앞으로 나아 가야지	과거는 중요하지 않아	0
배 터지게 먹었어	너무 많이 먹었나봐. 완전 배불러	0
클럽 가고 싶은데 말할까	클럽가고 싶은데 말하고 갈까	0
썸 타는데 고민 있어.	썸 타는 중인데 고민 있어.	0
선물로 인형 받았어	인형 선물 받았어	0
남친이 안 좋은 사이트를 하는거같아.	남친이 이상한 사이트를 들락거려.	0
짝사랑 포기하려니까 우울해.	짝사랑 포기하려니까 우울해.	0
친구들한테 인정받을 수 있을까	나 친구들한테 인정받고 싶어	0
서른초반. 전 즘 게시글 보며 안타까워.	세상 젤 아픈 이야기는.!!	1
사랑과 우정 사이	사랑과 우정 사이에 우리들	0
남친 승진 선물 추천	남자친구 승진 선물로 뭐가 좋을까?	0
기념일은 언제언제 챙겨?	기념일은 챙겨?	0
헤어진 사람이 생각나는데 어떻게 견디지	헤어진 여자친구를 다시 만나고 싶어	1
썸 타던 사이인데 부담 돼. 연락 무시해도 될까?	썸 타던 사이인데 이제 부담 돼. 연락 씹을까	0
집안일이 안 끝나	집안일 해도 해도 안 끝나	0
지긋지긋한 연휴.	지독하고 질긴 인연을 끝내려고 해	1
돈 많이 벌었으면 좋겠어	돈 많이 벌고 싶어	0
공부하기 힘들다	과거가 발목을 잡아	1
너무 답답해서 글올려	너무 보고 싶습니다.	1
답답한 마음만 드는 내 사랑	오랜 연애 끈을 놓을까?	1
짝남이 나한테 관심 없어보여도 계속 연락하고 들이대?	짝남이 나한테 관심 없어보여도 계속 연락하고 들이대?	0
전세집 구했어	전세 계약했어	0
너무 초라해지는 느낌이야	내가 너무 초라해	0
가족끼리 엄청 친한 사인인데 좋아하게 됐어요.	고백했다 차이거나 헤어지면 어떡하죠.	1
학교 가서 어떻게 얼굴 보지	학교 가면 볼텐데	0
한약은 왜이렇게 쓰지	한약 너무 써	0
무기력증 극복하는 방법	무기력증 어떻게 극복하지?	0
영화 추천	어떤 영화 볼까	0
한 번 보고 어떻게 판단하지	첫인상은 뭘로 판단할까	0
이무슨 신의 장난인지	이별 10일째 되어가네	1
사랑의 아픔은 사랑으로 치료한다	사랑이란 뭘까?	1
좋아하는 여자한테 선물해도 괜찮을까?	좋아하는 여자한테 선물해도 괜찮을까?	0
이제 기다리는게 습관 같아	기다림이 습관이 됐나봐	0
재미 없는 하루	그저 그런 하루	0
정말 무슨생각인지 궁금하네	정말 서로 좋았는데 엊갈림.	1
어떻게 해?	신기하다	1
재밌었겠네	함께 피맥 먹고 싶다.	1
또 야근	야근 좀 그만하고 싶어	0
긴연애의 끝인가	꼭 잡고 싶습니다	1
마지막 문자 아직도 가지고 있어	마지막 이별	1
완전 시간 아까워	시간 아까워	0
연락 없더니 갑자기 왜 만나자고 하지?	왜 이제 만나자고 했을까?	0
저녁밥 뭐 먹냐?	저녁 뭐 먹지?	0
여자친구가 소극적이야.	여자친구가 소극적이야.	0
미친 사람들이 너무 많아	사이코가 너무 많아	0
쌍커풀성형할까	성형할까	0
자꾸 왜 사랑이 식었는지 물어보고 싶어	자다가 이런 적은 처음이네	1
짝남이랑 만나기로 했는데 뭐 할지 추천 좀.	짝남이 학교에서 평이 안 좋아.	1
북극이야 왜케 추워	너무 추워	0
헤어진지 3개월째	헤어진지 3주.오늘 그 친구 생일	1
나 수학여행 간다	내일 수학여행가!	0
쭉쭉 나가야 하는데	뒤돌아 보지 말고 나가야 하는데	0
애니 좋아하는 사람 별로야?	애니 좋아하는 사람 별로야?	0
맘 떠난 사람이랑 계속 사귀기?	나한테 마음 떠난 사람이랑 계속 사귀기?	0
주차장이 꽉 찼어	죽는게 더 편할려나	1
짝녀한테 잘 보이고 싶은데.	짝녀한테 잘 보이고 싶은데.	0
월급 올라서 기분 좋아	월급 올랐어!	0
정신차리라고 한 마디 해줘	나 정신차리게 말해줘	0
스몰웨딩 결심했어	스몰웨딩으로 하려고	0
남친이랑 대화가 잘 돼서 좋아	남친이랑 대화가 잘 돼서 좋아	0
왜 남자친구 있는 여자를 내 마음을 흔들지?	왜 이별은 익숙해지지가 않을까	1
짝녀가 내 친구를 좋아하는 것 같음. 어떡해?	짝녀가 내 친구를 좋아하는 것 같음. 어떡해?	0
잠이 안 와	잠이 또 안와	0
정말 이건 너무하다 싶을정도로 힘들어	정말 처량하게 혼자	1
심남이 내가 좋아하는 거 눈치 챘을까?	내가 좋아하는 거 눈치 챘을까?	0
보고싶어서 미치겠는데	보내줘야 할 것 같아	1
연락이 없네	연락하지 말라고 했어	1
나 왜 사랑할까?	나 같은 애를 왜 사랑할까?	0
고시원 답답해	고시원 너무 답답해	0
저한테만 장난치는 남자애가 나 좋아하나?	저한테만 장난치는 남자애가 있는데 좋아하는 걸까요?	0
퇴근 후에 만나자고 해볼까	퇴근하고 만나자고 말해볼까	0
모든 걸 다 주니까 떠난다는 그 남자	다 해주니까 떠난다는 그 남자	0
하아 너무 많이 힘드네 ㅜㅜ	한 5개월쯤 됐네	1
짝녀 선물 어디까지 가능?	짝녀 선물 어디까지 가능?	0
여자 친구랑 헤어진지 23일째.	여자친구 무시했다가 이별 당했습니다.	1
타이밍이 기가 막혀	타이밍이 진짜 기막혀	0
몇번이나 매달려보셨어??	모든 것이 의미 없는 것이 되네	1
이별100일째.	이별노래 추천해줘.	1
미친 사람들이 왜 이렇게 많아	사이코가 너무 많아	0
연애는 하기 싫은데 썸은 타고 싶어.	연애는 싫은데 썸은 좋아.	0
오늘 마지막 인사를 하러가네	오늘 연락왔네 그래도 이젠 안녕	1
셀카 잘 찍어서 올리고 싶다.	셀카 잘 찍는 방법	0
이제 잊혀지는데 속도가 붙는거 같아.	이제 정말 놓으려합니다	1
잊어야하나?	잊지 못하겟어	1
흰머리 보여	흰머리 나	0
집착은 절대하지 말아야지	집착하지 말아야지	0
우리 추억들 모두안녕	우연히, 아니 몰래 보러간 그 아이	1
내 스타일 아니야	내 스타일 아니던데	0
이번주에 혼자 여행가려 하는데	이별 2달차 아직도 못 잊고 원망	1
3개월만에 연락이 왔어	3개월전에 헤어진 전남친이 문자했어	0
황당해 죽겠다.	황당해서 말도 안 나와	0
수면양말 포근포근 따뜻하다	수면양말 겁나 따뜻	0
사랑인지 아닌지 확실하지 않은 거 같아	사랑인지 아닌지 확실하지 않은 거 같아	0
먹을 게 일도 없어	먹을 거 하나도 없어	0
그녀 참 잔인하네.	그녀는 가끔 이라도 나를 생각해 줄까?	1
전여친생일 ㅎㅎ	전화가 왔는데 못받앗어	1
대체불가한 사람이 될 수 있을까	대체불가한 사람이 되고 싶어	0
커피향	커피향 좋다	0
신혼집 인테리어 어떻게 하지	신혼집 꾸미고 싶어	0
눈썹 문신 하면 편할까?	눈썹 문신 해볼까	0
엠티 안 가도 돼지?	엠티 꼭 가야해?	0
썸 타다 깨진 애 있는데 다시 연락해볼까?	썸 타다 깨졌는데 다시 연락해도 되나.	0
헤어진지 일주일째	헤어진지 한 달째	1
해결방안도 없으면서 불만만 많은 사람 극혐	자기도 해결방안이 없으면서 불만만해	0
좋아하면 먼저 연락해야 해?	좋아하면 먼저 연락해야 해?	0
친구랑 잘 노는 방법	친구랑 친해지는 법	0
남자친구랑 시간 더 보내고 싶어	남친이랑 오래 같이 있고 싶어	0
드라이브 하면서 데이트 해야겠다	드라이브 데이트 해야겠다	0
입맛이 너무 안 맞는 거 같애	입맛이 너무 다른 거 같애	0
책장 좀 치워야겠다	책장 정리 좀 해야겠다	0
끝나가니까 아쉬워	또 하루가 이렇게 가네	1
그냥 무작정 그녀 집에 갑니다	그냥 이별은 힘듬	1
나이 때문에 무시 받았어	나이 어리다고 무시해	0
오늘도 짝남이 멋졌어.	오늘도 짝남이 멋졌어.	0
만남과 이별	많이 사랑 했나보다	1
사랑하는사람	사진을 못지우겠네	1
코 조금만 세워 볼까	코 세워 볼까	0
취뽀 어렵다.	취업의 관문을 뚫는게 쉽지가 않네	0
배고픈데 집에 라면도 없어. 	라면 먹고 싶다.	1
후회가 몰려오네	휴 전남친 흔적찾기	1
말하고 후회할까봐 걱정돼	말하고 후회하면 어떡해	0
정말 복합적으로 힘드네	정말 아직 너무 사랑합니다 잡고 싶습니다	1
스튜디오 촬영은 하지 말까?	스튜디오 촬영은 하지 말까?	0
좋아하면 꿈에 나오는건가?	좋아하면 꿈에 나오는건가?	0
울적한 기분이 안 없어져.	마음이 울적해	0
주행 연습 끝났어	면허 따는 중	1
스트레스 주는 사람 어떻게 하지?	정신적으로 스트레스를 너무 주는데 이런 사람은 어떻게 상대해?	0
다른 사람들은 잘하는것 같아서 초초해	나만 제자리인듯	0
누가 더 사랑할까?	누가 더 사랑할까?	0
사랑하는건지 나도 모르겠어	사랑하는건지 모르겠어	0
녹차  마실래?	녹차 한 잔 어때?	0
뭔가 불공평해	불공평해	0
알바하면서 썸 많이 타?	화이트데이에 고백할까요?	1
그는 지금 뭐하고 있을까.	뭐하고 있을까.	0
왜 이렇게 태어났을까?	나는 왜 이렇게 태어났을까?	0
학벌이 중요한가	학벌이 중요하겠지?	0
휴대폰 없이 못 살거 같아	나 폰 중독인 거 같애	0
심장이 터질거 같네	쓰고 또 지우고 또 쓰고	1
뭔가 찔려	잘못한 거도 없는데 찔려	0
비오는날 뭐해?	비오는날 뭐할까?	0
살 좀 빼야되는데	살 좀 빼야되는데	0
가족을 너무 사랑해서 가끔 괴로워요	"가족들과 사랑하면서 지내고 싶어요"	1
오랜연애로 남자친구가 더 이상 새롭지않은게 고민임.	오랜연애로 남자친구가 더 이상 새롭지않은게 고민임.	0
이용당하고 버려진 느낌	이제 2주 좀 넘었네	1
못 놓구 있는 나.	못참고 연락.끝났네.	1
애완 동물 키우는 사람 성격 좋은가?	애완견 키우면 성격 좋아?	1
너 누구니?	너 뭐하는 애야	0
오늘도 공기가 뿌얘	오늘도 날씨가 뿌얘	0
식비가 어마무시하다	식비가 너무 많이 나와	0
이별이 좋은점	이별일까.?	1
친구들 부르려고	친구들 초대하려고	0
나 무시 당한 거 같아	나 무시하는 거 같아	0
조언 좀 구하겠습니다	종교 문제가 해결이 안되네	1
여드름 손으로 짰어	여드름 짰어	0
무슨 생각하고 있을지 궁금해	그 사람은 지금 무슨 생각일까?	0
더 이상은 아닌 것 같아	이젠 진짜 끝을 내야 하나	0
외로워서 그런건지 진짜로 좋아하는 건지 모르겠어요.	외로워서 그런건지 진짜로 좋아하는 건지 모르겠어요.	0
컨디션 조절이 안돼	컨디션 조절	0
피해 다니면 좋아했던 마음이 좀 사라질까?	피해 다니면 좋아했던 마음이 좀 사라질까?	0
썸 탈 때도 조건 보면 이상해?	썸일때 조건 보면 이상해?	0
휴.반년이라는 시간 잊었다 생각했지만 또 다시	흐음이거고민인데여;;	1
시험 없어지면 좋겠다.	시험 지겨워	0
다 힘들겠지?	나만 힘든 거 아니지?	0
화창한 날씨 포근한 햇살 나는.	환승이별 3달째를 앞둬도 힘들다	1
우리 같이 놀자	나랑 놀자	0
남자는 첫사랑 못 잊어?	남자들은 좋아하면 무조건 답장이 빠른가요?	1
발 맞춰 걷는 게 좋더라	나란히 걷는 게 좋더라	0
여친이 드디어 권태기가 온 거 같아.	역시 재회는 힘들어	1
고백합니다	저 오늘 고백할 겁니다.	0
이거 썸인가	썸 맞나	0
머리로는 이제 끝이구나 하는데	먹먹함	1
남친이랑 뭐하고 놀지	오늘은 남친이랑 뭐하고 놀지	0
남편이 효자인 거 같아	내가 그냥 아는 여자라네?	1
여행 와서 짝남 선물 살까하는데	연락 많이 안하는 썸도 있나	1
꿈에 자꾸 나와	꿈을 안 꿀 수 있다면	0
그냥 주절주절	그냥.너와 말한마디 섞고 너와의 인연에 고맙다	1
이가 차가워	이 시려	0
친구가 필요해	진짜 친구 사귀고 싶어	0
복 받겠지?	착하게 살면 복 받겠지?	0
사랑하지 않는데 만나는 거 같아	안 사랑하는데 만나는 거 같아	0
좋아하는 여자의 단점을 들었는데 어떻게 해야할지 모르겠어 답답해.	좋아하는 여자의 단점을 들었는데 어떻게 해야할지 모르겠어 답답해.	0
친구가 너무 고맙네	친구한테 진짜 고마워	0
남자친구가 잘못을 해도 다 공감해주는게 옳은걸까?	남친이면 잘못이라도 공감해주는게 옳은걸까?	0
야이 겁나게 미운 여자야!!	어느덧 이별 5주차	1
쓸데 없는 걱정 1위 연예인 걱정	연예인 걱정이 제일 쓸데 없어	0
학교생활이 조금만 더 재밌으면 좋겠어	더 나은 학교생활 하고 싶어	0
멋있게 잊어 주자	며칠 참다가 오늘 저녁에 또 터졌네	1
남자친구의 감정기복이 너무 심해.	남친 생겼는데 호칭 어떻게 해?	1
집나갈까	가출할까?	0
짝남이랑 저도 모르게 사이가 어색해졌어요.	짝남이랑 저도 모르게 사이가 어색해졌어요.	0
보내야지.	복잡해지네. 이거 어떻게 생각해야 될까?	1
상견례 너무 떨려	상견례 너무 떨려	0
남자친구가 표현을 하게하고싶은데 방법을 잘 모르겠어.	남자친구가 표현을 하게하고싶은데 어떻게 고치게 하지	0
커피 말고 딴 거 마실거 없나	커피 말고 뭐 마시지	0
뉴스는 역시 지루해	혼자 있으니까 편하네	1
엉엉 우는꿈 꿨어	에휴 추억을지우네	1
타로점 봤어	타로 보고 왔어	0
대학원 가는게 좋을 것 같아	대학원 가고 싶어	0
노래 가사가 참ㅠ 슬퍼	노래를 듣다가 눈물 나	0
중국어 좀 잘하고 싶은데 학원 다녀야 할까	중국어 학원이라도 다녀야 하나	0
꽃바구니가 좋을까 과일바구니까 좋을까	꽃바구니 선물이랑 과일 바구니 선물 뭐가 좋아?	0
여자들은 좋아하는데도 답장시간이 느릴 수 있나요?	좋아하는데도 답장 느릴 수 있나요?	0
짝남은 나를 싫어하나봐 기분 탓인지.	짝남은 나를 싫어하나봐 기분 탓인지.	0
바람기가 있는 남자친구 어떡해?	남자친구한테 헤어지자고 어떻게 말해	1
상대방의 마음을 사로잡는 방법	상대방의 마음을 사로잡는 비법 알고 싶다.	0
사랑이 끝나고 나서	사랑 이후 다시 세상은 회색빛으로.	1
미드 보고싶다	반딧불이 보고싶다	0
헤어진지 한달	헤어진지 한달짼데	1
도서관에 책 빌리러 가려고	책 빌려봐야지	0
난 또 바보ㅠㅠ	난 잘지내고 있어	1
남자친구를 믿는데 가끔 의심이 가.	남자친구의 입냄새가 고민이야.	1
답답해	답이 없는 남자	1
남편이 바람을 피우고 있습니다.	사랑받는 느낌이 안들어요	1
썸 기준이 뭐야	썸의 기준이 뭐야	0
빨리 정규직 하고 싶다	정규직 하고 싶다	0
연예인이랑 사귄다!	연예인이랑 사귄다!	0
좋아하는 사람 생기면 친신하고 그래?	좋아하는 사람 생기면 페북 친구 맺고 그래?	0
너무 바빠	할일 되게 많아	0
여자친구가 다른남자들에게 인기가 많은게 고민이야.	여자친구가 인기가 많은게 고민이야.	0
잠 살쳤어	잠을 많이 설치고 출근하네	0
잠수이별해도 될까	잡아야 되는건지 말아야 되는건지 모르겠네.	1
술 마셔도 안 취해	주량 쎈 게 좋은 건가?	0
안경테 바꿔야되는데	안경테 뭐로 바꿀까	0
살찔거 같은데 지금은 아주 행복하닼	괜히 파르르 하다 내가 넘어감	1
바다 가자	바다 가자고 물어볼까?	1
같이 할 수 있는 취미 생활 뭐 있을까	취미생활 같이하는 게 좋다던데	0
오늘마지막 통화후 깔끔히 정리	오늘은 그런 생각이	1
전세비 올려달래 어떡하지	전세비 갑자기 올랐어 어떡하지	0
짝남의 전 여친 등장.	짝남의 전 여친 등장.	0
헤어지기 전으로 돌아가고 싶어.	헤어지는게 서로를 위해 좋은거겠죠?	1
예랑이가 대리효도시키는 건 아니겠지?	예랑이가 대리효도시키는 건 아니겠지?	0
기대했는데	나 많이 기대했는데	0
정말 되고 싶은 사람이 없어	어른이 돼도 하고 싶은 게 없어	0
많이 좋아했는데 이젠 끝내야겠지.	이젠 끝내야겠지.	0
갑자기 심장이 덜컹.	갑작스러운 이별에 가슴이 무너져	0
서로 사랑해	많이 사랑해 	0
이별중이신 회원들을 위해.	이별하는 방법 중	1
짝녀에게 남친이 있었습니다.	짝녀에게 남친이 있었습니다.	0
남자친구와 여행 어디로 가?	남자친구한테 핸드폰 공개해?	1
양심적인 사람이 왜 더 고통받을까	우연히 만났는데 전혀 반갑지 않네	1
어제 헤어진 여친 학교 다녀 왔어.	어젯밤 꿈에나타났습니다	1
다시 만나서 이야기	다시 만날수 있을까	1
영어학원 좀 다닐까	영어학원 다녀볼까	0
남자인지 여자인지 알려줘	낭만이라고는 없어가지구	1
남자친구가 나한테 너무 집착해	남자친구가 나한테 집착하는 것처럼 느껴져	0
차별받고 있는 느낌	차별이 제일 싫어	0
아이고 소리가 절로 나온다	먹고 살기 힘들다	0
말투가 맘에 안들어	말투가 별로야	0
남자친구가 기념일을 잘 잊어.	남자친구가 기념일을 못 챙겨.	0
좋아하는 애 상메가 무슨 뜻인지 모르겠어.	좋아하는 애 가망 없으면 포기하는게 맞을까요?	1
중고로 샀어	중고 거래 했어	0
썸 끝난 건가	이제 썸도 끝난 건가	0
월급이 안들어와	사장이 월급을 안줘	0
너가 제일 기뻐해줬을텐데	너무 가슴이 아파	1
이 사람 나를 좋아하는 건가?	나를 좋아하는 건가?	0
고백하고 후회하면 어떡하지	공부는 내 체질이 아닌 것 같아	1
헤어짐 이후	헤어짐이 꿈이었으면 좋겠어	1
반동거중인 여자친구가 나갔으면 좋겠어.	거의 와서 사는 여자친구가 나갔으면 좋겠어.	0
좋아하는 사람한테 만나자고 말해도 되나.	좋아하는 사람한테 적극적인 여자 별로야?	1
남사친이 좋아졌으면 어떡해?	남사친이 좋아졌어.	1
새벽에 문득 잠에서 깨서 하는건.	새출발, 트라우마	1
나를 친구로 생각 안했나봐	나만 친구로 생각했나봐	0
2년 6개월 이렇게 끝나네	2년 다되가는 연애 끝.	1
아이돌 좋아하는데 남친이 질투해	드라마 보는데 남친이 질투해	1
로맨틱한 사랑 하고 싶다	나도 로맨틱한 사랑 하고 싶다	0
목 탄다	목 탄다	0
대답 잘하니	너 말 잘하니	0
오늘 날씨도 좋고 데이트각이야.	이런 봄날에는 데이트해야지.	0
지금 사귀고 있는 사람이랑 결혼하고 싶어	지금 사귀고 있는 사람이랑 결혼하고 싶어	0
좋아하는 사람이 여러명인데 괜찮겠지.	좋아하는 사람이 여러명인데 괜찮겠지.	0
짝남 전여친 못잊는거 보는게 너무 맘이 아파.	짝남 전여친 못잊는거 보는게 너무 맘이 아파.	0
사랑해	사랑해 자기야	0
남자친구가 나를 더 좋아하게 할 수 있는 방법	남자친구가 나를 더 좋아하게 만드는 방법	0
설날인데 재밌는거 안해	설날인데 볼 게 없어	0
갑자기 급우울	갑자기 일어난 일이라 어이 없어	1
사랑해서 헤어지겠대	사랑해서 헤어진다는게 말이 돼	0
나는 모든걸 걸어 널 사랑하는데	나도 모르게 니 생각을 하고 있어	1
좋아하는 남자가 여친이랑 헤어질 때까지 기다렸다가 고백하는거 가능한 사람이 있을까요?	좋아하는 남자애가 여친 생기면 울 줄 알았는데 덤덤해.	1
나 오늘 상 받았지롱	오늘 상 받았다	0
돈이 똑 떨어짐	돈 다 없어졌어	0
짝남이랑 술 마셨는데 기분만 더 더러워졌어.	짝남이든 썸남이든 뭐든 있었음 좋겠다.	1
나만 남친 없어	나만 솔로야	0
친구의 전 여친을 좋아하는 나.	친구의 전 여친을 좋아하는 나.	0
헤어진지 3달째인데 후폭풍 왔나봐 ㅠ	헤어진지 3주차 넘어가네~	1
썸도 후폭풍 옴?	힘든 연애 좋은 연애라는게 무슨 차이일까?	1
이사 왔더니 친구가 없어	지방 와서 친구가 없어	0
이혼	익숙해질 법도 한데	1
스테이크 먹으러 가고 싶어	스테이크 썰러 가고 싶어	0
도서관 책 반납 안햇다	책 반납 안햇다	0
나 얘를 좋아하는 걸까?	사랑일까	0
하루 이틀 이제는 사흘.	하루하루 너무 힘드네	1
하우스웨딩도 괜찮은 거 같아	하우스웨딩 하고싶다	0
썸타는 사람이 플라토닉 사랑을 이해해줄까?	썸타는 사람이 플라토닉 사랑을 이해해줄까?	0
연애중인데 외로운 느낌이 들면 문제일까?	연애중인데 외로운 느낌이 들어	0
오늘은 또 뭐 입냐	입고 나갈 게 없어	0
따듯해지니까 살 것 같다.	따듯해서 좋다.	0
술 마셨는데 썸남한테 데리러 오라고 할까?	이별 받아는 들이긴했는데	1
남자친구가 좋은데 눈치가 없어.	남자친구가 사람은 좋은데 눈치가 없어.	0
불꽃축제 보러 갈까?	놀이 공원 가자고 할까	1
양초 선물 받았어	양키캔들 선물받았어	0
다시 만날 수 있을까?	다시 사랑한다고 했는데.	1
술 먹고 짝남한테 카톡하는 거 좀 별로지.	이별 상태.	1
나도 휴학하는 게 나을까?	휴학가야 하나?	0
핸드폰 요금 많이 나옴	폰 요금 많이 나옴	0
짝녀한테 같이 스터디하자고 해도 되나요?	짝녀한테 같이 스터디하자고 해도 되나요?	0
본인을 좋아하는게 확실한 여자와 친구가 될 수 있어?	나 좋다는 여자와 친구하자고 해도 되나?	0
페북 했는데 다들 행복해 보이네	그 사람 행복하게 잘 살고 있기를	1
좋아하는 사람이 있는데 이제 못 봐.	좋아하는 사람이 있는데 이제 못 봐.	0
친구네 집에 놀러 가서 내일 오려고 	친구네 집에서 자야지	0
너무 비싼데 사고 싶어	사고 싶은데 비싸서 안사려고	1
가족이 누구야?	가족 있어?	0
연애는 어떻게 하는 거야	연애는 도대체 어떻게 하는거야	0
물 끓여서 차 마셔야지	물 끓여야지	1
지금이라도 중국어 공부할까?	중국어 공부할까?	0
저를 좋아하던 사람이 갑자기 매정해졌어요.	갑자기 매정해졌어요.	0
무상	무슨 말이라도 해주세요	1
최고의 영화	올 해 최고의 영화는 무엇인가	1
또 폭식했다.	나 폭식증인듯	0
싸움을 피하는 방법	안 싸우는 법	0
일주일이 일년같다	있을때 잘 할 걸	1
짝남한테 아침에 데이트 신청했는데 오늘 야근이야.	짝남한테 아침에 데이트 신청했는데 오늘 야근이야.	0
연애 세포 다 죽은듯	연애 감정이 안 생겨	0
꽃 사고 싶어	꽃 살까?	0
같이 있었는데.	거울 속에 비친 내 모습	1
변하지 않는 사람도 있겠지?	변하지 않는 사람도 있겠지?	0
새 핸드폰 갖고 싶어	새로나온 핸드폰 사고 싶다.	0
사랑했는데 왜 지금은 함께있지 않을까?	사랑면 함께 살고 싶지 않을까?	1
썸 타는 사이인데 너무 간섭이 심해.	썸 타는 사이인데 너무 간섭이 심해.	0
사랑하고 좋게 바꼈어	사랑하고 밝아졌어	0
나 속은거 같아	나 속은듯	0
결국 헤어졌네	결국 헤어짐이 확실해졌습니다	0
가슴은 계속 죽음만을 쳐다봅니다	가장 가까웠던 사람이 이제 가장 먼 사람이네	1
나 왜 이렇게 화냈었지?	왜 화냈었지?	0
아놔 왜 이러지	요즘 나 왜 이러지	0
앞으로 짝남 안봐야지.	화장 안했는데 썸남이 영통 걸었어. 어떡해?	1
이번 방학에 뭐하면 잘했다고 소문날까	요번 방학에 뭐하지	0
먹고 자고 놀고만 싶어	아무 생각 없이 놀고 먹고 싶어	0
누구랑 결혼해야 할까	어떤 사람이랑 결혼해야할까	0
이별후 첫 생일이네	이별후에도 나를 괴롭히는 그의 말들	1
구짝남한테 카톡했는데 읽씹해서 미련 없이 차단했어요.	군인인데 여자친구 보고 싶어	1
화장품이 필요해	화장품 사고 싶어	0
장학금 받으려면 독하게 해야돼	장학금 받고 싶다	0
내 번호를 따간 사람이 내 친구가 좋아하는 애야.	내가 더 좋아하는 거 같은 느낌이야.	1
힘드네.	힘든고 외로움	0
짝남에게 밤에 자주 산책하자고 해도될까?	짝남에게 밤에 자주 산책하자고 해도될까?	0
사랑은 시간이 약인가?	이별은 시간이 약인가?	1
같은하늘 다른공간	같이 욕해줘	1
언니가 있으면 뭐가 좋아?	자매가 있으면 좋은 점?	0
침대가 최고	오늘 침대밖으로 안 나가야지	0
오늘 집앞까지 찾아 갔는데	오늘 헤어졌습니다.	1
여자랑 단둘이 술마시는 남자친구를 이해해줘야할까?	여자랑 단둘이 술마시는 남자친구를 이해해줘야할까?	0
이별통보 받고 딱 일주일 째네.	이별하려고 하는데 정말 말 꺼내기가 힘드네	1
짝녀랑 카톡했던거 다시 읽어 보는데 거의 다만 물어보네.	짝녀랑 카톡했던거 다시 읽어 보는데 거의 다만 물어보네.	0
중2병인거 같아	중2병	0
후회하지말아	휴~~ 이제 글쓰는것도 멈춰야 할까	1
그녀의 모습을 보는 마지막 순간	그녀의 카톡이 없어졌다.	1
초콜릿 선물하면 좋아할까?	초콜릿 만들어서 줄까?	0
의외로 괜찮은 사람이네	의외인듯	0
시계를 돌려받고 싶은데.	신혼여행 가서 돌아오기 싫다	1
나 좋아하는 것 같아	금사빠인가	0
누군가를 짝사랑하게 되는게 두려워.	누군가를 짝사랑하게 되는게 두려워.	0
투자라고 생각 할 수도 있지	투자라 생각하는 게 나을까	0
부케 어떤 꼿으로 하지	부케 뭐로 하지	0
이별한지 11일째 아직은 힘드네	이별한지 3개월	1
꿈에 나온다는건 아직 못잊는건가?	꿈에서라도 보고싶어	1
다 내 잘못인 것 같아	다 내 잘못이지	0
모기가 너무 많아.	모기가 웽웽거려.	0
임신 했어 축해해주세요	아기 생겼어 축하해줘	0
상사가 진짜 미쳤다	상사 너무 싫은데 좋아질 수 있을까?	0
두 사람한테 거의 동시에 고백받았어	거의 동시에 두 사람한테 고백받았어	0
이젠 의미있는 시간을 만들어보려해	이젠 조금씩 생각이 변하네	1
짝사랑에서 연인으로 발전 가능?	짝사랑에서 연인으로 발전하려면 어떻게 해야 해?	1
알바 생각보다 힘들다.	알바하기 힘들다	0
퇴근하고 놀고 싶다.	퇴근하고 뭐 하지	0
근황이 궁금해	요즘 어떻게 지내는지 궁금해	0
함께했던 시간이 너무 많았기에.	행복할 수가 없어서 너무 아프고 불행합니다	1
의욕이 하나도 없다	의욕상실	0
포기해야할까?	하 끝나는 건가	1
요즘 노래 들으며 견디고 있어	용기내서 새해인사 했네	1
배 아파서 누워있어	회사가기 싫어	1
나라 사랑 큰나무 배지를 신청하고 싶어요	"라디오와 같이 사랑을 끄고 켤수 있다면"""	1
남자친구가 데려다 준대	남자친구가 나 집에 데려다 준대	0
공부하는 낙이 없어	공부하는 이유가 없어	0
웃을 줄 알았지	웃을 줄 알았지	0
술만 먹으면 연락 안되는 여친	술을 끊어야겠어.	1
남자친구가 살이 너무 쪘어	남자친구가 살이 짜꾸 찌는데 어떻게 해	0
화이트데이에 뭐 선물하지	화이트데이에 뭐하지	0
꼬시는 방법	사람 잘  꼬시는 방법	0
사랑하는데 왜 힘든 걸까?	사랑 맞는데 왜 힘든 걸까?	0
썸은 연락만?	썸은 연락만 주고 받는 사이인건가?	0
할 줄 아는 거 알려줘	뭐 할 줄 알까	0
사랑이 변하는걸 인정해야할까?	사랑이 변하는거지	0
4년넘은 인연이 끝이났습니다.	4년을 만났어도 인연이 아니었나 보네요.	0
학교샘 좋아하는 사람 있나?	학교샘 좋아하는 사람 있나?	0
첫사랑을 다시 만났는데 똑 같더라	첫사랑을 다시 만났는데 변하지 않았더라	0
썸 타고 있는데 주변에 말해?	썸 타고 있는데 주변에 말해도 돼?	0
결국 이별 종지부를 찍었네.	결국 핸드폰 번호 바꿨어	1
썸 중에는 선톡이 중요?	썸 탈때는 먼저 톡하는 거 중요?	0
그녀는 지금 무슨 생각을 할까?	무슨 생각을 할까?	0
조울증인가봐	좋아하지만 힘들어서 헤어지자고 먼저 얘기했어	1
여드름 폭발	여드름 올라와	0
안 좋아하는 법 좀 알려줘.	혼자 좋아하는게 이렇게 힘든 적은 처음이에요.	1
창업하면 어려워도 보람 있을거 같아	성과 내는거 보니까 부럽다	0
또 개강이라니	또 개강이야	0
왜 내 마음을 몰라주지?	왜 내 마음을 몰라주지?	0
짝남 여친 생겼네.	짝남 여친 생겼네.	0
좋아하는 여자한테 표현하는게 옳은 걸까?	좋아하는 여자한테 표현하는게 옳은 걸까?	0
택시비 너무 비싸	술 먹고 싶어	1
꿈에서 썸 나는 남자애가 자꾸 나와	꿈에서 썸 나는 남자애가 자꾸 나와	0
집에 아무도 없네	중국어 혼자 공부 가능한가?	1
다들 어떻게 견딜까	다른 사람들도 나처럼 이렇게 힘들까	1
으악	어머	0
글 썼다가 지우게 돼	기다리는게 답일까	1
헤어진지 한달 좀 넘었네	헤어진지 어언 10개월	1
축구 시청 중	축구 동영상 시청 중	0
어려 보이고 싶어	어려지고 싶어	0
애들이 썸 타냐고 물어봐	사람들이 썸 타냐고 물어봐	0
인테리어도 깔끔하게 하고 싶다.	부엌이 너무 낡았어	1
오늘은 2년전 그녀에게 고백했던날	오늘의 감정일기를 써볼까 합니다	1
좋아하는 사람한테 닮은 사람 봤다고 카톡 보내볼까?	좋아하는 사람한테 뭐라고 카톡 시작하지?	1
빚 때문에 죽을 것 같아	빚이 너무 많아	0
여자친구가 말을 듣기 좋게 해	여자친구가 가끔 막말하는게 거슬려	0
썸 타는 사이인데 늦게 답장 해도 돼?	썸 타는 사이인데 답장 늦게 해도 돼?	0
영화 추천 좀 해줘	요즘 무슨 영화가 재밌나	0
피씨방 가자고 말해볼까?	같이 피씨방 가자고 해볼까?	0
짝녀한테 크리스마스 선물로 뭐가 좋음?	짝녀한테 크리스마스 선물로 뭐가 좋음?	0
추억. 그 미칠듯한 그리움.	출근시간 아깝다	1
길에서 전번 물어보면 줘도 되나	길거리에서 연락처 물어보면 줘도 되나	0
말 좀 잘하면 좋을텐데	말 잘하고 싶어	0
단발 어울릴까?	단발 해볼까?	0
마음이 안오는 건 어쩔 수가 없나봐	마주쳤는데 최악	1
썸이었으면 좋겠다	썸이었으면 좋겠다	0
오늘이 마지막 매달림입니다.	오랜 연애 끝에 헤어짐을 통보 받았습니다.	1
밀당 어떻게 해?	밀당인가	1
소개팅하고 애프터까지 왔는데 너무 어색해.	소개팅하고 애프터까지 왔는데 너무 어색해.	0
나 혼자 야근해	나만 야근해	0
좋아하는 애한테 간접적으로 고백했는데 알아 차렸을까?	좋아하는 애한테 간접적으로 고백했는데 알아 차렸을까?	0
주름도 멋진 사람	주름도 멋져	0
괜히 농담해서 망했다	분위기 좋았는데 망했다	0
눈이 자꾸 나빠지는 것 같아	눈이 너무 나빠졌어	0
새벽	새벽에 전화가 왔네	1
나 같이 예쁜 애를 왜 갈구지	나만 갈궈	0
짝남이랑 저녁에 보기로 했는데 연락이 없다.	짝남이랑 저녁에 보기로 했는데 연락이 없다.	0
진심일까	진심일까	0
시계가 멈춘거 같아.	움직임이 없어.	0
썸 타는데 정리하고 싶어.	썸 탔는데 아닌 것 같아	0
수염 미는 게 낫겠지	수염 자르는 게 낫겠지	0
이거 좋아하는 거 맞나?	좋아하는 거 맞나?	0
몸매가 탄탄하면 좋은데	탄탄한 몸매 갖고 싶어	0
짝남이랑 아직 덜 친해서 오늘 아무말 대잔치함.	짝남이랑 계속 카톡하고 싶은데.	1
환승해야 하는데 지하철에 사람이 많아	나 기다려 줄까	1
과일 챙겨 먹어야지.	과일 먹어야지.	0
이 나이에 모르는게 왜 이렇게 많지	나 모르는게 왜 이렇게 많지	0
짝남 생각에 잠을 못 자.	짝남 보고싶다.	1
또 바람일까	또 전화 안받아	1
구썸남 보고싶어.	구썸남한테 연락하고 싶다.	0
썸타는 사람이 많은 거 같은데	썸타는 사람이 많은 거 같은데	0
다른 사람들이 나 좋아했으면 좋겠어	다 나 좋아했으면 좋겠어	0
울적한 기분	울적하다	0
이별을 받아드리질 못하고있네	이별을 앞둔 이들에게	1
남자친구 오지랖 너무 많아	오지랖 남친 때문에 속상해	0
학원 선생님을 좋아하는데 티내면 안되겠지.	학원 선생님을 좋아하는데 티내면 안되겠지.	0
오늘 점심 뭐 먹을까	오늘 점심은	0
나 좀 봐줬으면 좋겠어	나 좀 좋아해 주지	0
복전하니까 힘들다	복전 이렇게 힘들 줄이야	0
꽃말인 사랑인 꽃 좀 알려 줘	괜찮은 사랑이 올까요	1
고집하고는	고집 센 사람	0
만난지 7년 헤어진지 5일째	많이 괜찮아졋지만 여전히 찌질한 모습의 나	1
이별 통보를 받게 되면 어떻게 해	이별 한달차입니다	1
술먹고 연락도 없는 	술만 먹으면 전화를 안 받아	0
정말 아무것도 하기 싫은 마음이 들어요	계속 마음이 빈 것 같아	1
머리 좀 다듬을까	머리 다듬어 달라고 그럴까?	0
버림 받은 느낌	나 버림 받은 거 같아	0
자길 좋아하는 여자애가 있으면 더 잘해주는 경향이 있나?	자길 좋아하는 여자애 더 잘해주나?	0
공연 보고 싶어	공연 보러 가고 싶어	0
중국어 있는게 좋겠지?	중문 있는게 낫겠지?	0
자꾸 아침 먹으래	아침 안 먹는데 자꾸 먹으라고 그래	0
내가 좋아할 자격이 있나 모르겠어.	내가 좋아할 자격이 있는걸까.	0
이제 와서 소문이라니	이제 자리 잡아가는데	1
잠수이별이라니!	잠이 안오네	1
제주도 바닷가 가고 싶어	제주도 가고 싶어	0
부자 되게 해주세요	돈 벌고 싶어	0
유학 준비하는 여자친구	유학 간다는 여자친구	0
나 좋아하는 건지 궁금해	좋아할 때 나타나는 특징 있나	0
말로만듣던 환승에 치가 떨리네	맘이 떠났다는게 맞는거 같아	1
나는 뭐든 할 수 있다.	나 할 수 있어	0
카드값 너무 많이 나왔어.	카드값 갚느라 허리가 휘어	0
잘 되라고 한건데 더 어색해졌어	이어주려고 해서 더 어색해졌어	0
이별한지 8일째	이별한지 이제 일주일째네	1
그도 나를 좋아했으면 좋겠다.	걔도 나를 좋아했으면 좋겠다.	0
다른 사람들도 이런 재회 바라나?	다시 돌아오거나 연락이 올까.	1
썸 타는 사람이 내 프사 보고 귀엽대.	썸 타는 사람이 내 프사 보고 귀엽대.	0
이 지각쟁이	자꾸 늦는 사람	0
흠 또 괜한 의미부여	힘드네 정말	1
좋아하는 사람이 있는데 사귀는 건 싫어.	좋아하는 사람이 있는데 사귀자고 해볼까	1
썸에서 연인될 수 있을까	썸에서 연인으로 발전할 수 있을까	0
잊을 수가 있을까	잊혀져 가는게 더 아프내	1
남자친구가 있는데 다른 사람을 좋아하는 것 같애.	남자친구가 말고 다른 사람이 좋아졌어	0
야근할 줄 모르고 약속 잡았어	약속 있는데 야근이네	0
오늘따라 보고싶다.	오늘부터 내려놓기로 했습니다.	1
공부 좀 더 할 걸	어렸을 때 공부 좀 할 걸	0
서류에서 떨어지다니	왜 서류에서 떨어지지?	0
여친 쌩얼보고 깜놀했어	여친 쌩얼보고 깜짝 놀랐어	0
결혼 결심한 이유 있어?	왜 결혼해?	1
사랑만으로 다 될줄 알았던 우리들	사랑은 찾아오는 것일까!	1
여자친구가 돌아다니는걸 너무 좋아해	여자친구가 너무 돌아다니는 것 같아	0
운명적인 사랑을 했어	운명적인 사랑을 했어	0
잠깐 괜찮았는데	잠수이별인지 아닌지 잘 모르겠어	1
휴가를 못가	휴가 못 쓰게 해	0
썸남 졸업하는데 가도 되나?	썸남 졸업식 가도 되나?	0
친구들은 다 예뻐	친구가 예뻐서 위축돼	0
급하게 살 빼야 해	물 많이 마셔야 하는데 까먹어	1
낼 짝남한테 잘 보이고 싶어.	낼 짝남한테 잘 보이고 싶은데 뭐 입지.	0
여자친구가 표현을 하게하고싶은데 방법을 잘 모르겠어.	사랑 표현 하게 하고 싶은데 방법을 잘 모르겠어.	0
사랑의 결과는 어차피 두가지	사랑했는데 헤어져야 할까	1
계속 엇갈리는 느낌	우리 계속 엇갈림	0
선자리 들어왔어	선 들어왔어	0
짝사랑 하는 사람 보려고 일부러 갔어	짝사랑도 나에게는 힘든 건가	1
뒷담화 좋아하는 사람 어떻게 생각해요?	뒷담화하는 사람 어떻게 생각해요?	0
내가 좋아하는 거 알았는데도 나를 대하는게 변함이 없어.	내가 좋아하는 거 알면서 똑같이 대해	0
한달만에 제가 먼저 연락했습니다.	한달이라는 시간이 흘렀습니다.	1
긴 머리가 잘 어울렸던 그녀	긴 생머리가 어울렸던 그녀	0
발렌타인데이에 고백할까요?	이번 발렌타인데이에 고백할까요?	0
사랑할수록 아프다	사랑할수록 뭔가 맘이 아프다	0
차단여부를 어찌아시나???	차인후 연락이 오나?	1
이닦았는데 잇몸에서 피나	잇몸에서 피나는 거 같애	0
면접 준비 방법	몇번을 경험해봐도 너무 아프네	1
나를 좋아하지 않는 그 사람이 너무 미워.	나를 좋아하지 않는 그 사람이 너무 미워.	0
여자친구에게 옷선물 좋은 브랜드있어?	여자친구에게 옷선물 좋은 브랜드 있어?	0
요즘 핫한 건?	요즘 핫한 게 뭐야	0
이뤄진 연애는 없는 듯.	가까이 가기에는 너무 멀리 있어	1
궁금하지?	궁금하면 오백원	0
저녁 준비 해놔야지	저녁해야 되는데.	0
오늘 하늘 예쁘다.	하늘이 너무 예뻐	0
나란 놈 참 신기한 놈이다.	나를 선택의 기로에 놓이지 않게하라	1
운동화가 나을까? 구두가 나을까?	운동화 신을까? 구두 신을까?	0
강아지 좋아하는 여자 어때?	같은 과에 내 남자애가 좋는데 씨씨는 무리1일까?	1
짝남이 연락이 안 되는데 자고 있는 걸까?	짝남이 연락이 안 되는데 자고 있는 걸까?	0
서운한거를 다말해? 아니면 어디까지 말해?	서운한거를 다말해도 돼?	0
이별이란 참 힘드네	이별증후군	1
남편복 있다는 의미가 뭐야?	남편복 있다는 말이 무슨 뜻이야?	0
여친이 화난 이유를 아직도 모르겠어	여자친구가 왜 화났는지 모르겠어	0
사내 연애 비추하나요?	사내 연애 비추지?	0
나라사랑카드 뭔가요? 	나를 먼저 사랑해라 영어루	1
좋아하는 여자애 꿈을 꿨는데 눈을 못 마주치겠음.	좋아하는 여자애 꿈을 꿨는데 눈을 못 마주치겠음.	0
남자친구가 전화를 잘 안해	남자친구가 전화하는 걸 안 좋아해	0
마음이 너무 아픕니다.	친구 사이로 지내자고 하네	1
눈이 아파	폰을 오래했나 눈이 너무 뻑뻑해	0
헤어진지 2달	헤어진지 2주쯤 됐군	1
애인이 생겼답니다.	양가 부모가 원하지 않는다면	1
짝녀 줄 센스있는 선물 추천 좀 해주세요.	짝녀 줄 센스있는 선물 추천 좀 해주세요.	0
아기 선물은 뭐가 좋음?	애기 돌선물은 뭐 사지?	0
이 세상에서 내가 제일 불행해.	내가 제일 불행해.	0
다시 만나서 사랑할 수 있을까?	더 사랑해줘	1
후련해	후폭풍이 올까 두려운데.!	1
마음이 완전히 식은 남자	마지막 그녀를 만났어	1
사생활 좀 존중해줬으면	서로의 사생활 좀 존중해줬으면	0
커피가 너무 진해	커피가 너무 써	0
짝남한테 문자 왔는데 뭐라고 답하지	짝남이랑 어색해졌어 괜히 너무 나댔나	1
인정 받고 싶은거 당연한 거 아니냐	인정 받고 싶다	0
사랑을 했다	사랑을 했다	0
모르는 애랑 썸타는 꿈 꿨어	썸타는 꿈 꿨어	0
머리 짧게 잘라야지	머리 확 잘라버려야지	0
욕먹었어 여자친구한테	여자친구가 욕했어	0
어떤 사람 꿈 꾸고 나서 호감 생겼어.	꿈에 나오고 나서 호감 생겼어.	0
아무말이나 하다가 헤어졌어.	아무 생각 없다.	1
논문 쓰기 힘들다	논문이 잘 안 써져.	0
내 남사친이랑 잘되고 싶어 그는 나를 여자로 봐줄까?	내가 남자를 좋아하는 줄 알았는데.	1
오늘 처리할 일이 쌓인다	오늘 처리할 일 너무 많아	0
다 잊었는줄 알았는데.	다 괜찮은 줄 알았는데	0
배가 너무 고파	배고파	0
뒷통수 제대로 맞음	뒷통수 맞았어	0
어떤 남자애가 나 내일 뭐하냐는데 뭐라하지?	나 내일 뭐하냐는데 뭐라하지?	0
내 마음 들킨 거 같아	내가 너무 몰아붙였나봐	1
아직 좀 불편한데 잘 사귈 수 있을까?	우리 잘 사귈 수 있을까?	0
아기 좋아하는 남자 어때?	아기 좋아하는 남자 어때?	0
너무 오래한 연애	너무 화나.	1
너무 잘해주면 질려하나?	너무 잘해주면 질려하나?	0
아는 오빠와 친구가 친하게 지내서 잘 될까봐 걱정이야	교회에 좋아하는 오빠 있어	1
게임도 이제 재미없어	게임 지겨워	0
온라인 연애 상담해볼까	완벽한 이별 후	1
김치찌개 먹고 싶어	참치김치찌개 먹고 싶어.	0
사랑해라고 왜 말 안하지	왜 사랑한다고 말 안하지	0
다육이 좀 심어볼까	화분에 뭐 심어볼까	0
필름 끊겼었네	술먹고 필름 끊겼어	0
여자가 먼저 키스하면 가벼워 보일까?	여자가 먼저 키스하면 가벼워 보일까?	0
그녀도 나를 좋아했으면 좋겠는데.	나 좀 좋아해 주면 좋겠다.	0
여자들은 직장 내에 좋아하는 남자 생기면 어떡해?	직장 내에 좋아하는 남자 생기면 어떡해?	0
마음이 식은 거 같아	요즘 마음이 식은 거 같아	0
택시 타야겠다.	그냥 택시 타야지.	0
사랑 경험이 없어	사랑해 본 경험이 없어	1
위로해 주고 나니까 내가 힘들다	위로가 필요해	1
마음을 세게 먹는 방법 있나?	헤어지자는 남자친구 잡는 법	1
이제 은퇴해야 하나?	잘 나갈 때 은퇴해야하나?	0
맘 정리했는데 다시 연락하고 싶어요.	맘 정리한 줄 알았는데 연락하고 싶어요.	0
거지같은 이별	겁나 열받어	1
확실히 날 좋아하는 걸 아는 남자랑 친구가 될 수 있을까?	날 좋아하는 남자랑 친구가 될 수 있을까?	0
사랑이 쉬운 사람	쉽게 사랑하는 사람	0
커플 사진 왜 공개 안하지	프로필에 내 사진 안 올려.	0
한약 먹고 싶지 않다.	한약 먹기 싫어	0
부모님이 같이 살자셔	부모님 모실 수 있을까?	0
대기업 인턴하고 싶다.	인턴하고 대기업 입사면 좋겠다.	1
둘 다 바보였다	드디어 바닥을 찍었네	1
친구들이 나보구 귀엽다고 했는데	친구가 나 귀엽대	0
상처가 많은 사람을 사랑하는 것은 힘든 일이었어.	상황이 어찌됐던 간에 내가 못잊겠으면 연락을 했겠죠.	1
정말 잘 맞는 사람이 있을까?	정말 잘 맞는 사람이 있을까?	0
손이랑 발이 차가워	손 시려	0
좋아하는 선배가 나한테 연락했으면 좋겠어.	좋아하는 선배가 나한테 연락했으면 좋겠어.	0
기운이 없어	긴여정 끝에 헤어졌습니다	1
취준생인데 연애 해도 될까?	취준생인데 연애 부담 돼.	0
썸 타는 줄 알았는데 짝사랑이었네.	힘든 연애 좋은 연애라는게 무슨 차이일까?	1
남자친구가 술만 마시면 연락이 안돼.	남자친구가 술 먹으러 가기만 하면 연락이 안돼.	0
치맥먹으면서 축구봐야지	축구 볼때는 치맥이지	0
적금 들어야 하나	적금 들까	0
앞머리 다시 길러볼까	앞머리 길러볼까	0
여자친구에게 해줄만한 화장품 선물 뭐가 있을까?	여자친구 화장품 선물 뭐가 있을까?	0
3년 연애 끝에 여친이랑 헤어지고 한달 되었네요.	3년 만난 여자와 헤어진지 한달 되었습니다	0
시어머니가 자꾸 카톡해	시어머니가 카톡해	0
친구 사귀는 방법	처음에 친구 어떻게 사귀지	0
점심시간에 외출하면 안 되나	점심시간에 외출하는 것도 눈치봐야돼	0
무료 상담 받았는데 마음 접으라고 하네	무섭습니다	1
이별 후 1년 그리고 선물	이별 후 다른 이성 소개팅 후 후폭풍	1
진짜 이건 뭐.	진짜 정신병 걸릴꺼 같은데	1
썸 왜 끝났지	썸 왜 끝났지	0
팬미팅 재밌다.	팬미팅 갔다왔어	0
짝녀가 날 너무 친구로 생각해.	짝녀가 날 너무 친구로 생각해.	0
다시 보기는 봤는데 결국은.	다시 보기는 봤는데 결국은.	0
헤어진지 이제 고작 하루	헤어진지 하루.	0
집까지 데려다줬는데 호감? 그냥 매너?	집까지 데려다줬는데 호감? 그냥 매너?	0
입냄새 안나나?	입냄새 나나?	0
미치겠네	미치겠어	0
다 맞춰주고 싶은 사람	대화가 안 통해	1
뭐 이렇게 끝나냐	마지막 문자 보냄	1
왜 비난만 할까	내가 말하면 왜 비난만 할까	0
남자친구가 연락이 너무 늦어.	남자친구가 연락이 너무 늦어.	0
그게 되니	그냥 나를 위해 살고 싶어	1
이제 나도 날 좋아해주는 사람을 만나고 싶어.	이젠 다시 사랑 못할 것 같아.	1
한쪽이 마음 떠나고 마음 돌리는 방법	해가 지는게 두렵네	1
내일 결혼식이야	드디어 내일 결혼식이야	0
좋아하는 사람이 있는데 자괴감 들어.	좋아하는 사람이 있는데 자괴감 들어.	0
남친이 자꾸 자꾸 귀척해	남자친구 너무 귀여워	1
상처	상처는 치유되지 않아도 아픔은 무뎌질테니.	1
매일 아침 정류장에서 마주치는 남자애가 신경쓰여.	아침마다 정류장에서 마주치는 남자애가 신경쓰여.	0
기다리고 있습니다	기다리지 않았다고 하지만 기다렸어	1
이젠 조금씩 화가나네	이해심이 부족한 나.	1
소문 날까봐 무서워	입소문이 무서워	0
이별은 원래 힘들자나	이별을 먼저 말해본적있나??	1
매달려보셨어??	모든 것이 의미 없는 것이 되네	1
짝녀가 음식을 가리는 편인데 뭘 먹으면 좋을까?	짝녀가 음식을 가리는 편인데 뭘 먹으면 좋을까?	0
너 웃겨	너 정말 웃겨 ㅋㅋㅋ	0
비오는날	뻔하다	1
예쁘다고 말해줘	성형 안해도 예쁜데	0
내가 좋아하는 사람이랑 나이 차이가 많이 나는데 괜찮을까?	좋아하는 사람이랑 나이 차이 괜찮을까?	0
담배 비싸	담배 너무 비쌈	0
팀장님을 좋아하게 됐는데 고백하면 안되겠지.	팀장님을 좋아하게 됐는데 고백하면 안되겠지.	0
좋아하는 여자애한테 밥 먹자고 했는데 바쁘다고만 해.	좋아하는 여자애한테 밥 먹자고 했는데 바쁘다고만 해.	0
감정컨트롤을 못하겠어	감정컨트롤이 안돼	0
이사해야 되나	이사 힘들어.	1
또 주말	또 주말이네	0
좋아하는 사람에 대해 착각만하게 되는 내 자신이 싫어.	좋아하는 사람의 심리를 모르겠어.	1
내가 진짜 둔한데 나를 좋아하는지 모르겠어.	나를 좋아하는지 모르겠어.	0
목소리 좋은 사람이 좋아	감미로운 목소리 좋아	1
나 부담스러워할까	너 가족 있어?	1
수분크림 듬뿍 바르고 자야겠다.	수분크림 바르고 자면 나아질거야	0
썸 중에 고백 언제가 적절해?	썸 타다가 고백하고 싶은데 언제가 적절해?	0
밤샜어	해 뜨는 거 보고 잤어	0
고양이 키우고 싶어	애완동물 키우고 싶어	1
무섭게 빨라	자꾸 봐주니까 기어오른다	1
결혼 날짜 잡아	결혼식 날짜 잡으려고	0
널 사랑하지 않아	네번 헤어졌습니다	1
가족들 보고 싶어	엄마 보고 싶어	0
내가 좋대	내가 좋대	0
컴터가 맛이 갔어	통증	1
전화해야 되나	전화할까 말까	0
그냥 친구하자네	그녀 생각에	1
나 너무 소심해	내 성격 너무 소심해	0
남자친구에게 시계 선물해주고싶은데 어느 브랜드가 좋을까?	남자친구의 혼전순결이 고민이야.	1
제 2 외국어 뭐할까	제2외국어 뭐 선택할까	0
여자친구 만나고왔어~	여자친구와 헤어지고 세운 목표들	1
운명인 것 같아	운명인가	0
짝녀랑 조금이라도 닮으면 눈이 가는 듯.	짝녀랑 조금이라도 닮으면 눈이 가는 듯.	0
여자친구에게 고민이나 속사정을 어디까지 얘기해?	여자친구에게 고민이나 속사정을 어디까지 얘기해?	0
반장을 좋아해.	우리 반에 반장을 좋아해.	0
짝녀 생각에 잠을 못자겠어.	짝녀 생각에 잠을 못자겠어.	0
이별 후 들으면 더 힘든 노래들	이별 후 한달 경과 보고서	1
짝사랑 하는 남자애가 이사 간대.	짝사랑 하는 남자애가 이사 간대.	0
짝남한테 주말에 만나자고 했는데 일 있대 계속 언제 되는지 물어봐도 되나.	짝남한테 주말에 만나자고 했는데 일 있대 계속 언제 되는지 물어봐도 되나.	0
썸녀가 그냥 오빠 동생으로 지내자 했음.	그냥 오빠 동생으로 지내자 했음.	0
요즘 내 옆에 아무도 없어	혼자라서 편할 떄도 많아	0
못생긴 남자를 좋아하는 여자가 있을지.	나처럼 못생긴 남자를 좋아하는 여자가 있을지.	0
짝녀가 있었는데 못 잊겠어.	짝녀가 있었는데 못 잊겠어.	0
헤어진 여자친구한테 화이트데이날 사탕 주면 않되겠죠?	헤어진 지 이제 2주정도네.	1
여사친이 좋아진 것 같애.	여사친이 좋아졌어.	0
헤어진 남친의 SNS 행적	헤어진 여자친구	1
축의금 얼마해야 되나	축의금 고민	0
짝남한테 고백했는데 내가 싫지는 않은데 못 사귀겠대.	짝남한테 고백했는데 내가 싫지는 않은데 못 사귀겠대.	0
맨날맨날 똑같아	별다른 게 없는 일상	0
유용할 듯한데	개강이야 올해도 기대되	1
오늘 짝남 만나는데 옷이 없다.	오늘 짝남 만나는데 뭐 입지.	0
허리가 계속 아파.	허리 아프다	0
여자친구가 연락이 안돼	여자친구가 연락이 안돼	0
사진 예쁘게 찍고 싶다.	사진 잘 찍고 싶어	0
덕질 중	덕질 하는 중	0
덤덤해지는데	독한 불면증	1
면접 어떻게 잘 보냐	면접 잘보고 싶어	0
친구 결혼 준비하는 거 보니까 나도 하고 싶어진다	친구 결혼 준비하는 거 보니까 나도 하고 싶어진다	0
짝녀가 이사간다는데 너무 힘들어.	짝녀가 이사간다는데 너무 힘들어.	0
어떻게 부자가 될 수 있나?	부자 되는 방법	1
이제 그만하고 쉬고 싶다	그냥 쉬고 싶다	0
아닌건 아니다	아무것도 아닌 글에 화가 치밀어 오르네	1
하루 종일 놀고 숙소에 들어와 휴식	만두 맛있어 또 먹고 싶어	1
병무청 시계는 지금도 간다	군대 언제 끝나나	0
썸 타는 사람 보고싶어.	오늘따라 썸 타는 사람 보고 싶어.	0
참아야 하나	참는 게 나을까	0
헤어지자고 끝났고 다정리했다면서	헤어지지 말자더니 놔버린 나쁜놈	1
수박 맛있어.	수박 먹어야지	0
고백해도 될까?	고백할까	0
조카 선물 고르기 어렵네	조카 선물 뭐 사주지	0
이건 정말 위기야.	위기야.	0
여친이랑 다툼	연락 말라고 모질게 했내 결국	1
내 여자로 만들기	내가 사랑하는 사람이 나를 사랑했으면	1
이별해야 하나?	이별후 3개월 다되가는데.	1
점심시간엔 그냥 쉬고 싶어	점심시간이라도 마음 놓고 쉬고 싶어	0
사랑하는지 자꾸 물어보는 이유	사랑하냐고 왜 자꾸 물어보지?	0
나는 사랑 표현이 어색한데 여자친구는 너무 적극적인 표현을 원해	나랑 사귈래?	1
생각해주는 척만 한거였어	생각해주는 척하더니 더한 사람이었어	0
이렇게 헤어지게 되네	헤어졌어.	0
비참하다.	사는게 힘들어.	1
으아 속상해	나 너무 속상해	0
오디션 도전해볼까	오디션 나가볼까	0
상황이 최악이다	상황이 안 좋아	0
아오 그놈에 꿈	아직도 그대로인걸	1
썸 끝내고 싶어	썸타는 거 같아서 싫어	0
나보다 2살 어린 남자를 좋아하는게 비정상이야?	나이가 어린데 연애를 해도 될까?	1
손 잡고 싶어	어떻게 해 손잡고 싶어	0
이별을 받아들이는 게 맞는걸까?	이별을 준비하고 있습니다 .	1
찬물만 나와	따뜻한 물이 안나와	0
썸만 타고 싶어	힘들어서 결혼할까봐	1
말실수했다	생각 없이 말했어	0
너무하네 진짜	진짜 너무하네	0
아침에 벌떡 일어났네.	아프다	1
간식 뭐 먹을까	간식 추천	0
나도 그림 좀 잘 그렸으면 좋겠다	내 친구들은 다 그림 잘 그려.	0
같이 먹었는데 나만 살찐 거 같아	연애하고 나만 살 쪘나봐	0
여친 생겼는데 호칭 어떻게 함?	여친 호칭 어떻게 함?	0
첫 출근 날이야	오늘 첫 출근이야	0
세상이 너무 무서워	세상이 무서워	0
엠티 가는데 짝남이랑 같은 조 됐으면 좋겠다.	엠티 가는데 짝남이랑 같은 조 됐으면 좋겠다.	0
아직 많이 부족한데 어떻게 해	내가 너무 부족한 느낌이 들어	0
가족 여행 고고	가족 여행 가기로 했어	0
여자친구가 변해가는거 같아.	여자친구가 변해가는거 같아.	0
이별 앞에 씩씩해지기	이별 일년 반	1
남자친구앨범속에 지우지못한 전 여자친구 사진 이해해야할까?	남자친구의 틀리는 맞춤법이 거슬려.	1
학교에 좋아하는 오빠한테 어떻게 다가갈까?	학교에 좋아하는 여자애의 관심을 어떻게 끌지?	1
임용 시험 기다리고 있어	임용 기다리고 있어	0
작년 오늘.	잘 지내고 있네	1
고백 언제 하지	고백	0
사다리타기 맨날 운이 안 좋아	사다리타기 맨날 꽝이야	0
취업은 너무 힘들겠지?	취업하기 힘들겠지?	0
도와준 사람들 너무 고맙다.	힘든데도 날 도와준 사람	0
남자 보통 어디서 만나	남자 어디서 만나	0
평생 저주할거야	저주할거야	0
오늘 꿈에서 그녀가 먼저 카톡 해줬어	오늘 또 헤어진 사람의 sns를 봤네	1
여친이 오히려 섬세하지 못해	여친이 섬세하지가 안아	0
딴 거 뭐 할 줄 알아?	너 또 뭐할 줄 알아?	0
신혼 진짜 행복해	신혼 진짜 행복해 결혼하길 잘했다.	0
일 하면서 알게 된 사람한테 연락해도 될까?	일 하면서 알게 된 사람한테 연락해도 될까?	0
짝남 행동 헷갈려 나한테 호감이 있는 걸까?	짝남도 나 좋아하는지 궁금해	0
공시 붙자 마자 결혼하재	관심을 받는다는거.	1
놀러 와라	우리집에 놀러와	0
남편이 어느 여성과 톡을 주고 받는 걸 보았습니다 	사랑의 온도가 다른 것 같아요.	1
신기해	신기한 일들이 많이 일어나	0
솔로들만 이해 ㅠ	순진했던게 죄인가.	1
썸은 얼마나 타	썸은 보통 얼마나 타	0
미련이 남아서	미안하대	1
남자친구가 술먹으면 개가 돼	남친이 녀석 술먹으면 개가 돼	0
이게 뭐라고 떨려	별거 아닌데 떨려	0
썸 타다 늙어 죽을 듯	썸 타다 죽을 듯	0
피자 먹고 싶다.	피자 땡기네	0
준비 안됐는데 썸남 지금 집 앞에 있대.	준비 안됐는데 썸남 지금 집 앞에 있대.	0
이별 사유가 내 맘에 안들어	이별 이야기 하나	1
비트코인 망함 한강 가자	가상화폐 쫄딱 망함	0
썸녀랑 어떤 대화를 해야 해?	회식하는데 나만 챙겨줘. 썸임?	1
짝남한테 톡 와 있네.	짝남한테 톡 와 있네.	0
사람 마음이란게 참	사람을 잊는게 이렇게 힘들 줄이야	1
썸 탈 때 말투	썸 탈 때 말투 신경쓰여	0
몰래 동거하고 있어	부모님 몰래 동거하고 있어	0
책 선물이 제일 나을 듯	책 선물해야지	0
고민상담 가능?	혼자 살아야 할 듯	1
썸 사이에서 원래 질투유발하고 그래?	원래 질투 나고 그래?	1
착각인걸까	참 너란 여자	1
좋아하는 그사람은 바람둥이야 좋아해도 될까?	좋아하는 남자애가 게임을 좋아하는데 이야기 오래가는 소재 좀 알려줘.	1
아무래도 우울증 걸린 거 같아	우울증 걸린 거 같아	0
환승 가능?	이 순간 뭘하면 좋을까	1
다리 떨면 진짜 복나가나?	다리 떨면 안 좋아?	0
뒤척이다 늦잠 자게 되네	요즘 잠을 늦게 자	0
설레고 싶은데 아직 좋아하는 사람이 없어.	아직 맘 설레게 좋아하는 사람이 없어.	0
이벤트 안하는 남자친구	이벤트 모르는 남자친구	0
놀러가기 딱 좋은 날씨다	오늘 날씨 좋아서 놀러가고 싶어	0
번호 따볼까나	번호 달라고 해볼까?	0
월급이 왜 똑같지?	최저임금 올랐다는데 월급은 왜 똑같지?	0
으으 화장실 급해	쉬마려	0
사랑받고싶어	나도 요즘 사랑 받고 싶어	0
보통 좋아하는 애 생기면 먼저 연락해?	좋아하는 애 생기면 먼저 연락해도 돼?	0
어장관리 당한 걸 알게 됐어.	어장관리 당한 걸 알게 됐어.	0
아직 마음을 모르겠는데 고백해도 돼?	아직 확신 없는데 고백해도 돼?	0
혼자 노력하는 연애인 거 같아	혼자 노력하는 연애인 거 같아	0
전 결국 밑바닥까지 보고말았습니다	전 여자친구가 카톡 친추에 떴어	1
이젠 잡아도 안되는거래	이젠 증오가 될거같네	1
보내지 못하는 전할 수 없는 메시지	봄의 계절이 찾아왔네	1
언제까지 덮을 수 있을까?	언제쯤 예쁘게 화장 잘할까	1
상사한테 또 혼남	상사한테 또 깨졌어	0
로그인 아이디 기억안나	로그인 아이디 까먹었다	0
일요일에 교회끝나고 어디 가고 싶어.	일요일에 교회만 가	0
짝녀랑 누나 이름이 똑같애.	짝녀랑 누나 이름이 똑같애.	0
연락해도 될까?	이른 시간에 연락해도 될까?	0
체험활동 진행중	체험활동 하러 왔어	0
불 날 뻔했어	불 날 뻔	0
늘 뒷모습만 보여줬어	나한테 뒷모습만 보여줬어	0
그렇게 오래 살았는데도 이해를 못하겠어	오랜 시간을 함께해도 이해하지 못하겠어	0
연애할때 많이 사랑하면 나만 손해야?	연애할때 많이 사랑하면 나만 손해야?	0
썸 깰 때 어떻게 해?	괜히 썸타는 분위기 싫어	1
애기가 밥을 안 먹어	애기가 밥을 너무 안 먹어	0
사랑하는 사람이랑 결혼하고싶어	사랑하는 사람이랑 결혼하고 싶은거 당연한 거 아니야?	0
할 말 있대 뭘까?	나한테 할 말 있대 뭘까?	0
막 말하는 거 고치고 싶어	나 함부로 말하는 거 고치고 싶어	0
그냥 고백할걸	만나서 고백할걸	0
자야겠다.	잘래	0
눈이 피곤해	눈이 침침해	0
꽃 예쁘게 말렸어	드라이플라워 만들었어	0
다시 웃게 해준 사람	데이트 계획을 너무 나만 짜는거같아.	1
누군가를 좋아한다는건 정말 힘들일이야.	누군가를 좋아한다는건 정말 힘들일이야.	0
마음 맞는 사람이 있을까?	어디 나랑 마음 맞는 사람이 있을까?	0
자꾸 헷갈리게 해	헷갈리게 해	0
연극 보러 갈까	같이 연극 보러 갈까	0
지금 연락해도 돼?	지금 연락해도 돼?	0
화를 한 번 내는게 나을텐데	화를 못내	0
헬조선 떠나고 싶다	이민가고싶어	0
거짓말처럼 돌아왔으면 좋겠다	겨우 힘든 맘 추스렸는데 연락오네	1
6년그리고남은 것들	7년 내남자	1
롯데월드 가자고 해볼까?	놀이동산 가자고 해볼까?	0
썸남한테 뭐라고 카톡하지	썸남한테 뭐라고 카톡하지	0
너 미워	미워한다	0
향수 뿌려도 될라나	향수 뿌리면 티나나?	0
인정받으려면 어떻게 해야 하나	나 인정받고 싶어	0
첫눈에 반해서 좋아할 수 있어?	첫눈에 반함	1
잘 챙겨주는데 나를 좋아하는 걸까?	자꾸 챙겨주는데 나 좋아하나?	0
너무 잘해주는 남자 만나서 다행이다.	나한테 잘해주는 사람 만나서 행복해	0
늦잠과 브런치 수다가 있는 주말	주말에 늦잠자고 브런치 먹으면서 수다 떨고 싶어	0
눈물이 납니다. 무슨 눈물인지 모르겠지만	뉴스는 역시 지루해	1
한달이넘었는데 괜찮은거같은데	한때는 나의 전부였던 그녀	1
이별이 아닌 사별	이별이.아픈것도 슬픈것도	1
좋아하던 사람에 대한 감정으로 내가 너무 힘들어.	좋아하던 사람에 대한 감정으로 내가 너무 힘들어.	0
남편은 진짜 남의 편인가?	남편은 진짜 남의 편인가?	0
시트지로 붙여야겠다	시트지로 리폼해야겠다	0
축의금 얼마 정도 내야 할까?	축의금 고민 된다.	0
전 여자친구가 마지막으로 얼굴 한 번만 보자고	전 여친에게 카톡 보내는 꿈 꿨어	1
사수가 깐깐하게 군다	내 사수 너무 깐깐해	0
서로 사랑하는데 불안해	사랑하는데 불안해	0
파혼위기	평온한거 같은데 행복하지가 않네	1
놀아줘 놀아줘	나랑 놀아줘	0
미친듯이 보고싶어	미칠꺼 같습니다 정말.	0
자꾸 신경쓰여	자꾸 신경쓰여	0
지옥같은 주말.	직장과 이별	1
연예인 되는 방법	연예인 되고 싶어	0
헬스장에서 자주 보는 여자가 보고싶어	헬스장에서 자주 보는 여자가 보고싶어	0
헤어지는게 편하겠죠?	헤어지자고 말했어 마음이 찢어지네	1
만족할 줄을 몰라	만족을 모르나봐	0
썸 타는 여자가 남사친 만나러 간다는데 뭐라 해?	회식 중이라고 하는데 연락이 안돼.	1
물 차가워	물 너무 차가워	0
나는 친구라고 믿었는데	나만 친구라고 생각한건가	0
연상 어때?	연상도 괜찮지 않나?	0
다 부질없는짓 같아.	다가온 이별	1
뒤에 누가 따라 오는 것 같아 무서워	뒤에서 발자국 소리 나서 놀램	0
썸남이 둔한듯	썸남이 좀 많이 둔한 듯	0
사랑한 만큼 배려해야했어	사랑한 만큼 배려해야 했어	0
썸남 졸업하는데 선물 뭐가 괜찮아?	썸남 졸업 선물 뭐가 좋을까?	0
실수했다.	일하는데 실수를 많이 해	0
썸남 초콜릿 줘야 해?	썸남 초콜릿 줘야 하나?	0
세상이 감미로워 보여	세상이 빛나 보여	0
배워도 모르는 게 너무 많아	모르는 게 너무 많아	0
미련 남은거랑 좋아하는 거랑 뭐가 다름?	미련이랑 좋아하는 거랑 뭐가 다름?	0
지금 노력한다고 될까	노력해도 안되는 거 같애	0
우정의 정의	술만 먹으면 전화를 안 받아	1
썸 탈 때 어디가?	썸 탈 때 놀러 가자면 어디가?	0
기회도 없네.	깊은고민	1
그래이제  결정했어	나 결정했어	0
짝남한테 게임 초대 톡 왔음.	짝남한테 게임 초대 톡 왔음.	0
잘 지냈으면 좋겠다	잘 지냈으면 좋겠다	0
이제 더이상 남자친구로 안느껴진다는 그녀	이제 밥도 잘 먹구 술은 안마시면 되겠는데	1
어제 술마시고 나서 기억 안나	술 먹고 필름 끊겼어	0
꿈에 그 사람 나왔어	그 사람을 꿈에서 만났어	0
첫사랑과 이별	첫이별이라 그런지 너무 힘드네	1
친구들은 다 예쁘게 하고 왔어	친구가 너무 예뻐	0
직장인도 방학이 필요해	직장인도 방학이 있었으면 좋겠어	0
친구같데.	카톡 보냈어	1
짝남이랑 페북친구인데 짝남이 좋다했던거 태그해도 되나?	짝남이랑 페북친구인데 짝남이 좋다했던거 태그해도 되나?	0
미친듯이 덥다	더워더워	0
연애한지 2년째야	연애한지 2년째야	0
이별 후 다시 사귀는데 휴	이별 후 3개월이 지났는데.	0
소개팅으로 여러번 만났는데 고백하면 너무 빠른가	매일 매일 오빠하면서 연락하고 지내는 사람 있어	1
참는방법 좀	참아야겠지	1
창문을 열어 놓고 나왔네	창문을 열고 나왔네	0
쏘주	씁쓸하네.	1
진실된 사랑이 있을까?	진실된 사랑이 있을까?	0
완전 어이없네	왔다갔다	1
문 여는 소리같은게 나서 무서움	번호키 누르는 소리가 나서 무서움	0
오늘부로 최악의 남자가 되었습니다	오늘은 아프다	1
뵘 되니까 살 것 같다.	봄 되니까 따듯해서 좋다.	0
밝은 사람 만나고 싶어	환한 사람 만나고 싶어	0
월세 너무 아까워	월세 아까워	0
보조 배터리 안 가지고 왔다	충전기 안 가지고 왔다	0
썸 시작인 거 같은데 사귀고 싶어	썸 시작인 거 같은데 사귀자고 하고 싶어	1
헤어지고나서 보내는 두번째 주말이네	헤어지는 중.이였어.	1
썸남한테 책 같이 읽자고 할까?	썸남한테 책 같이 읽자고 할까?	0
혼인신고 하러 왔어	혼인신고 하러 왔어	0
연인이랑 어떻게 하면 안 싸울 수 있을까?	어떻게 하면 안 싸울까?	0
새이불 뽀송뽀송 	새 이불 덮었어	0
카톡할때 너무 칼답하면 부담스러워할까?	카톡할때 너무 바로 답하면 부담스러워할까?	0
정말 왜 이러는걸까	정말 제가 이해가 안갈 정도로 잘못한건가?	1
남자친구가 연락 안 하고 외박했어	연락 안 하고 외박했어	0
썸 타다 고백할 시기?	썸 타다 언제쯤 고백하면 되나?	0
무엇을 하든 늘 따라다니는 너	문득 듣고픈 노래.	1
너무 힘든 나날을 보내고 있습니다.	너무 힘들어서 미치겠네	0
다시 보기는 봤는데 결국은.	다시 와도 싫다고 단호하게 말해야지	1
주변에서 제가 그녀를 좋아하는 거라는데 받아들여지지 않습니다.	주변에서 제가 그녀를 좋아하는 거라는데 받아들여지지 않습니다.	0
마음만은 항상 청춘인데	마음만은 청춘이야	0
졸려	오늘 너무 졸려	0
이 순간 뭘하면 좋을까	마음이 진짜 너무 아프잖아.	1
복근 좀 생겼으면	복근 만들어야지	0
썸 타는데 맨날 늦게 들어가서 피곤하대	썸 타는데 맨날 피곤하대	0
평생 함께하고 싶다.	프사 무슨 의미 일까?	1
한심하네ㅜㅜ	할 수 있다면 그럴수 있다면 달라질까?	1
여자친구와 이별한지 정확히 1년이 되는 날이네	여쭈어볼것이있습니다	1
잠이 계속 와	잠이 너무 와	0
아침에 눈뜨기 힘들어	니 생각 때문에 힘들어	1
썸남이 넘 좋아	썸남한테 너무 좋아하는거 티내기 싫은데	0
이 시간에 라면 먹고 싶은데 살 찔 거 같아	야식 먹고 싶은데 살 찔 거 같아	0
다리가 퉁퉁 부었어	다리가 부은 거 같아	0
말이 너무 심해	폭언하는 사람 어떻게 해?	0
힘든 사랑	힘들고, 힘들고, 또 힘들고,	1
자격증 딸거야	자격증 공부해야지	0
사랑 끝난 거 같은데 잡으면 돌아올까?	돌아서는 사람 잡으면 돌아올까?	0
외식 너무 많이 했다	이번달에 외식 너무 많이 했다	0
단거 땡긴다.	달달한 거 먹고 싶다.	0
자취해야할듯	자취해야할듯	0
바래다달라고 말해볼까?	바래다 줄까	1
블랙박스로 보면 나올까	블랙박스 제대로 찍혔을까	0
하 고놈의 술이 뭔지 참	하나하나 다 신경이 쓰이네	1
운명적인 사랑을 믿었는데	운명적인 사랑 있어?	0
머리는 헤어지는게 맞는데.	머릿속에서 계속 생각이 나	1
전화 와라	전화벨이 울렸으면	0
나도 집 사고 싶어	집 사고 싶어	0
오늘 백일이야	오늘 우리 만난 지 백일됐어	0
나 미쳤나바	나 좀 말려 줘	1
오늘도 짝사랑하는 여자가 정말 이뻤습니다.	오늘도 짝사랑하는 여자가 정말 이뻤습니다.	0
치우긴 했는데 걸레질도 해야 돼	걸레질 해야 하는데 귀찮다.	0
커플이 같은 옷 입는거 좋아보여	나도 커플룩 입고 싶다	0
이게 뭐지	이러고있는게 잘하고있는건지.	1
썸 타는 것도 귀찮아.	썸 타는 것도 귀찮아.	0
출근 준비하다 또 울었네	침묵	1
농구하다 무르팍 깨짐	농구하다 다쳤어	0
나 어때?	나 괜찮지 않니	0
여자친구가 교환학생 간대	여자친구가 교환학생 다녀온대	0
연애상담해줬더니 나만 바보됐어	연애상담해주던 사람이 좋아지는 거 같아	1
일이 너무 한꺼번에 생겨	일이 너무 많아	0
좋아하는 사람 앞에서 실례를 했어.	좋아하는 사람 앞에서 실례를 했어.	0
남자친구가 사업한대	남자친구가 사업 시작한대	0
자꾸 바보짓을 하고 있네	자꾸 이상한 생각이 드네	1
오랜 연애인데도 좋아	오랜 연애인데도 좋아	0
자꾸 짝녀 얼굴 생각나네.	자꾸 짝녀 얼굴 생각나네.	0
과연 돌아올까?	괜찮다가도 불쑥불쑥 올라오네	1
공황장애 생겼어.	공황장애 있어	0
돈 버는 게 어렵구만.	돈 버는 게 쉽지 않음	0
수능 어떻게해	수능 떨린다	0
좋아하는 사람이 날 싫어해서 죽고 싶어.	그 사람이 날 싫어해서 죽고 싶어.	0
먹고 자도 놀기만 해도 될까	먹고 자도 되나	0
택배 아저씨 오셨을까?	택배 왔나	0
내일 발렌타인데이인데	너 뭐니?	1
이별한지 벌써 한달하고 2주.	이별할 수 없는 아픔	1
쇼핑하고 싶다	쇼핑 좀 해볼까	0
친구들이 브라이덜샤워해준대	친구들이 브라이덜샤워해준대	0
목걸이 선물이 좋겠다.	목걸이 선물해볼까?	0
시간이 가고 있나?	시간이란 약의 부작용	1
인간관계 관리하는 거 힘들어	사람 관리하는 게 제일 힘들어	0
좋아하고 있는 애랑 카톡하는 중인데 뭐라고 하지?	좋아하고 있는 애랑 카톡하는 중인데 뭐라고 하지?	0
한강 가서 맥주 마시고 싶다.	한강에서 맥주 캬	0
내 이상형이 뭔지 모르겠어.	내가 생각했던 사람이 맞는지 확신이 안들어	1
바쁘네	오늘 좀 바쁘네	0
한쪽만 호감이면 짝사랑인거지	한쪽만 호감이면 슬프지?	1
쌩얼인데 짝남 만났어.	화장 안했는데 짝남 만났어.	0
흡입했더니 졸려	폭풍 먹방했더니 졸려	0
스키 배워보고 싶다.	스키 안 타봤어	0
평일 저녁 데이트 장소 좀 추천해줘	평일 저녁 데이트 장소 추천	0
그렇게 잊어가는구나	그리움이 나을가아픔이 나을가	1
남은 휴가가 없어	휴가가 없어	0
피부가 다시 조금씩 좋아지고 싶어	피부 좋아지고 싶어	0
한 사람을 오랫동안 좋아하는게 신기하대.	한 사람을 오랫동안 좋아하는게 뭐가 신기해.	1
오래 만나는 방법 있어?	오래 만나고싶은데	0
썸은 왜 타?	썸은 왜 타게 되는 걸까?	0
썸을 오래 탔는데 사귀어도 되는 거야?	썸을 오래 탔는데 사귀어도 되는 거야?	0
내 가치관이랑 다른 가치관을 가지고 있는 그 남자를 좋아하는게 힘들어.	내가 그를 생각하는 만큼 그도 나를 생각할까.	1
열받아서 막 전화에다가 화풀이했어	오늘 너무 힘드네	1
뭐하면서 놀까	뭐하면서 노는 게 좋을까	0
힘껏 아파하고 몸부림 치면서 살고 있어	힘드네. 정말.이런건 줄 몰랐어	1
입맛없는데 뭐 먹지	입맛없어	0
인생 뭐있나	인생 허무해	0
봄방학했어	봄방학이다!	0
막말 최악이지	막말이 제일 나빠	0
짝남한테 밥 먹자고 해볼까.	짝사랑 하는 사람한테 어떻게 연락하지?	1
스트레스 참기 어렵다	스트레스 받아	0
나 이번학기부터 교직이수 가능할까?	성적 망쳤는데 교직이수할 수 있을까?	0
짝녀한테 고백했는데 미안하대.	짝녀한테 고백했는데 미안하대.	0
사랑하는 사람이 행복했으면 좋겠다	사랑하는 사람이 행복하면 좋겠다	0
좋아하는데 자꾸 짜증나기도 해.	좋아하는데 자꾸 시비걸게 돼요.	0
짝남이 있는데 어떻게 고백하지	호감가는 사람이 있는데 뭐라고 말 붙여 보지	0
부자되게 해주세요	돈 많이 벌고 싶어요	0
좋아하는 사람 얼굴이 이제 생각이 안나.	좋아하는 사람 얼굴이 이제 생각이 안나.	0
잘하는게 없는 느낌	나 잘하는게 없는거같아	0
잊혀진다는거	자기중심적인 여자.	1
알바 구해볼까	부업할까?	0
남자가 돈을 더 써야하는게 일반적이야?	남자가 계산하는게 일반적이야?	0
짝남이 내 친구를 좋아하는 것 같아.	짝남이 내 친구를 좋아하는 것 같아.	0
오늘은 결재가 나야 할텐데	오늘은 결재 받아야지	0
불금이네	불금입니다	0
스타트업에 투자하는거 어때?	스타트업에 투자해볼까?	0
지금 이감정	지나고나면 .	1
썸남한테 먼저 연락해도 될까?	썸남한테 먼저 연락해도 될까?	0
죽을 때까지 함께하고 싶은 사람이 생겼어	죽을 때까지 함께하고 싶다	0
아파	아픈 상처	0
오늘 또 하루 살았네	나는 그냥저냥 사는 거 같아	0
지쳐서 헤어지자고 한 남자도 후폭풍올까?	진정 헤어진 여친 맘은 못 돌리는 건가?	1
사랑하는데 너무 계산적인 남자친구가 고민이야.	너무 계산적인 남자친구가 고민이야.	0
기억이나 할까	긴 연애 끝에 헤어짐	1
아 덥다더워!	날씨가 진짜 더워	0
그 사람이 나를 좋아하는 줄 알았는데.	그녀가 내 연락을 부담스러워할까?	1
그녀와 같은 조가 하고 싶어.	같은 조 되면 좋겠다.	0
여자친구가 돈이 너무 없어.	여자친구가 돈이 너무 없어.	0
이별후 여친페메 무슨 의미일까?	이별후 한달반만에 그사람이 좋아하는 사람이 생겼다는걸 알아버렸네	1
혼자 술 마실만한 장소 없을까?	혼자 잘 살 수 있을까?	1
지금 마냥 행복하다.	욜로!	0
노는 거 좋아하는 사람은 좋아하면 힘들거야.	노는 거 너무 좋아하는 사람은 좋아하면 힘들거야.	0
항상 내편이 생겨서 좋아	내편이 생겨서 좋다고 생각했는데 편 안들어줘	1
분식 먹고 싶아.	김떡순 먹고 싶어.	0
묘하게 자꾸 끌려	이상하게 자꾸 좋아져	0
여자친구가 술을 못마시는데 분위기를 좋아해서 자주 술마시러가는게 고민이야.	여자친구가 술을 자주 술마시러가는게 고민이야.	0
그나저나 힘들긴 힘드네.	그냥 답답하네.	1
남자들은 이쁜 여자만 좋아할까요?	남자친구 부모님 만났는데 진짜 좋았어	1
물리치료 받아야 하나 	물리치료 받아야겠다	0
기분 나쁜 농담을 계속하고 있어	나는 기분 나쁜데 농담이라고 계속해	0
사랑하면 안될 사랑을 사랑하고 있어	좋아하면 안될 사랑을 좋아하고 있어	0
궁금해 알려줘	궁금해	0
선생님이 좋아	선생님 좋아해	0
사랑 참 어렵다	사랑은 가슴으로 이별은 머리로	1
한 눈에 반했어. 그녀한테 좋아한다고 해도 될까.	그녀한테 좋아한다고 해도 될까.	0
아무래도 탈모왔나봐	탈모인가	0
노래방 걸 거 같은데 뭐 부르지	노래방 데이트 할 거 같은데 뭐 부르지	0
사랑이 뭘까 궁금해	사랑이 뭘까?	0
드라이가 잘 안돼	드라이 잘 안되네	0
기프트콘 받음	기프트콘 받았어!	0
업무 끝내고 집 갈 수 있을까	업무가 쌓여있어	0
양말 구멍 난거 지금 봄	양말 구멍 났다	0
나 왜 멍청해	멍청한게 탈이지	0
사랑한다고 말을 안해줘	사랑한다는 말을 안해	0
걔도 날 좋아하는 건지 매너인지 모르겠음.	같이 있으면 너무 좋아	1
헤어지는게 맞는걸까?	헤어지자 말한 사람도 힘들까?	1
공부 때려치워야 하나	계속 공부해도 될까	0
좋아하는 사람 앞에서 표정 관리 안되는 거 어떡해?	좋아하는 사람 앞에서 표정 관리 안되는 거 어떡해?	0
차단 반복하는 이남자 뭔가	차라리 죽는게 나을듯한 이별의고통	1
버스 기다릴 때 가면 자꾸 생각나	버스 정류장하면 생각나	0
어제 오늘 멘탈이 나갔네	어제 정말로 완전히 보냈습니다	1
머릿속에 너만 가득해	머릿 속에 니 생각만 나	0
전공 살려서 취직할 수 있을까	전공 못 살릴듯	0
재수학원에서 연애는 필망?	재수학원에서 연애는 망하는 지름길인가	0
되는 일이 하나도 없네	요즘 되는 일이 없네	0
고3은 공부만 해야겠지.	고3은 공부해야겠지	0
자다가 깨서 분노	자연스럽게 헤어진 건가?	1
하늘 날 수 있는 차 생겼으면	하늘 나는 자동차 생겼으면	0
이제 10일차 이별	이제 괜찮습니다. 그래서 힘드네 이젠.	1
만든 사람 이름 알아?	너 만든 사람 누구야?	0
뱃살 빵빵	뱃살이 잡혀	0
썸타는 거 가능?	썸 같은데 헷갈리네	1
반지 많이 비쌀까	반지 비싼가	0
착해서 잘해주는 건지 좋아하는 건지	착해서 잘해주는 건지 좋아하는 건지	0
예쁘게 하고 클럽가서 놀아야지	화장하고 클럽 가서 놀라야지	0
너무 잘해줬더니 당연한줄 아네	너무 잘해줬더니 이제 당연한줄 아네	0
이별할때 남자들의 거짓말	이별후 10개월 만의 연락. 그후.	1
9년 연애 환승이별	jk김동욱 노래 생각나네	1
사랑하면 안되는 사람	사랑하면 안되는 사람	0
21살의 사랑에 대해	사랑을 노력한다는게 말이 되나요?	1
교양 듣는데 심남 있음. 	교양 시간에 심남 발견	0
지하철에 자리가 없어	오늘 유난히 지하철에 자리가 없어	0
잘 안되는군	잘해줘도 안되는건 안되네	0
요즘 웃을 일이 없네	웃을 일이 없네	0
별로인 거 알면서도 좋아하는 내가 이상해.	별로라면서도 좋아하는 내가 이상해.	0
썸남한테 크리스마스 선물 오바?	썸남한테 크리스마스 선물 오바?	0
너무 배가 불러	배불러	0
남자친구랑 종교 문제로 다툼	남자친구랑 종교가 달라	0
내가 다시 만나자면 나랑 만나줄까	내가 다시 만나자면 나와줄까	0
사진 업로드해야겠다.	사진 올려야지	0
좋아하는 여자에 프사가.	좋아하는 여자에 프사가.	0
전 여친이 드디어 연애를 시작했네.	전남자친구 생일	1
사랑받는 방법	사랑 받는 방법 알려 줘	0
나한테 목적 가지고 접근한 거 같아	목적이 있어서 접근한 거 같아	0
너한테 쓰는 편지	넌 잘살더라	1
세탁소 가기도 귀찮네	세탁소 가기 귀찮네	0
남자친구랑 말이 안 통해	요즘 남자친구랑 말이 안 통해	0
나 말 실수한 거 같아.	나 실수했나	0
결혼하면 행복해질까?	결혼하면 행복해?	0
방법도 안 말해주고 그냥 열심히 하래	모르겠는데 노력하래	0
아련하게 조금씩 잊게 되나보네	아무것도 안되네	1
서로 좋아하는 것 같은건 내 착각일까?	너두 나 좋아하는 줄 알았는데 내 착각일까?	0
머리했다.	먼저 이별통보해도 후폭풍이 오나?	1
성격이 너무 달라서 자주 싸워	여자친구가 세상에서 제일 예뻐	1
엄마 기대 때문에 부담돼	엄마가 나한테 기대가 너무 큰 거 같아서 부담스러워	0
잊어야 할것들이 너무 많아	잊을수 없는 너.	1
할 말이 생각 안나	할 말 없다	0
착각	찬사람 차인사람	1
헤어진지 2개월차 잊혀지질 않네.	헤어진진 거의 1년	1
썸남이 연애가 다 짧은게 맘에 걸려.	썸남 보고 싶다.	1
괜찮은 줄 알았다.	괜한 희망은 더 큰 절망을	1
사랑은 부작용과 휴유증을 길게 남긴다	사랑의 반대말.	1
여자친구랑 연락문제로 자주 싸워	연락문제로 자주 싸워	0
사랑할수록 집착해	사랑할수록 집착하게 해	0
집 다와서 사귀던 남자애 만났어	집앞에서 전남친 만남	0
미련	미련이 없다고 생각했는데.	0
마음에 드는 여자가 있어요	내 맘에 꼭 드는 여자가 있어요	0
에라이!!!	에휴.	1
맥주 소주 어떤거 마실까	맥주 마실까 소주 마실까	0
건물주가 짱인데	건물주 되고싶어	0
블루투스 이어폰 편하겠지	블루투스 이어폰 살까	0
어떤 피자 먹지?	피자 시켜 먹을라고	1
제가 이상한 건가요?	제발 그만 좀 나와주라.	1
그 사람이 나 좋아해줬으면 좋겠다	내가 좋아하는 사람이 나 좋아해줬으면 좋겠다	0
삼겹살 구워 먹고 싶다.	삼겹살 먹고 싶다	0
앞머리 만들까?	앞머리 내릴까?	0
그 사람이 날 좋아하는 이유가 뭘까.	그녀는 나를 어떻게 생각할까?	1
잘못된 만남	뭔가 잘못된 만남 같네	0
집착인 것 같기는 해	집착인가봐	0
연예인과 썸 타는 꿈 해몽 좀	연예인과 썸 타는 꿈 해몽 좀	0
낮술먹는날 우울터짐	내 마음을 정리하기가 어려워	1
사랑하는 사람 내가 붙잡는 거 같애	안 사랑하는 사람을 내가 붙잡는 거 같애1	0
욕 먹을 준비 돼있다.	우리 진짜 이별인가봐	1
기다림	기숙사 괜찮을까	1
이상하게 이 친구한테는 집착하게 된다	친구한테 자꾸 집착하게 돼	0
갑작스럽게 연락이 왔네.	같이 보고싶어서 올려~	1
만나자	만나자고 말해야지	0
여자로 태어 났으면 어땠을까?	여자해보고 싶어	0
짱나는새끼	차단당했네	1
성공할 수 있을까	잘 살고 싶어	0
돌아올거란 생각부터 하지 말걸	독하게 정리	1
난 금사빠라서 오랫동안 좋아하는 사람 보면 신기해.	남녀간의 소통의 중요성을 다시 한번 깨달았습니다.	1
공부 잘 안돼	공부 하기 싫다	0
남친한테 교회 가자고 하고 싶어	남자친구 교회 데려가고 싶어	0
제 맘이 안별할까요?	제가 좋아하는 사람이 맘 잡고 공부해야할 것 같다고 하네요.	1
잊지마	잊고 싶지 않아	0
남친이 나를 좋아하는게 맞겠지?	남친이 나를 좋아하기는 하나?	0
벌써 그 사람이랑 3년 사겼어	3년째 연애하고 있어. 좋아	0
어제 새벽에 이별했어.	어제 이별을 했습니다	0
의외로 병신들이 많다	이 몸쓸 놈의 마음이참 변덕스럽네	1
정말 너무 궁금해	정말 모두 잊고 새출발할꺼야	1
결국 이런 운명이라니 슬프다	운명이 슬프다	0
여자친구가 너무 챙김받고 싶어해	여자친구가 너무 받고만 싶어해	0
임신했어	임신이면 어떡하지	0
너무 끔직한 5월의 연휴도	너무 답답해 조언 좀 해줘	1
여친 있는 짝남이랑 연락을 해도 될까?	오래 연락 안했는데 연락을 해도 될까?1	1
썸타는 사람이랑 갈만한 식당 추천	썸인데 먹으러 어디 가는게 좋음?	0
이 현실에서 도망가고 싶어	현실에서 도망치고 싶어	0
머리 자라서 뿌리 염색 다시 해야 되겠다	너무 머리가 빨리 자라. 다시 뿌염해야지	0
쉬는 중입니다.	놀아 줄 사람이 없어	1
예전 추억 생각나	어릴 때 생각나	0
더 이상 안 왔으면 좋겠어	더 이상 나한테 안 왔으면 좋겠어	0
속았나	나 속은 거 같아	0
아무거나 다 잘하는 사람	니가 내 옆에 있어줘서 고마워	1
같이 가는줄 알았는데.	걔 없이 잘지내 보려구	1
사랑해서 그런거래	사랑해서 그렇다는데 말이 안돼	0
요즘 사람이 무서워	사람이 제일 무서워	0
점 보러 갈까	점 볼까?	0
자꾸 뭘 사게 돼	쇼핑 중독인가봐	0
진급 누락됐어	나만 진급 못했어	0
습해서 땀이 절로 흐르는 날씨	온도보다 습한게 더 싫어	0
사내커플인데 비밀연애하니까 더 떨려.	비밀연애하는 사내커플 떨려.	0
표정이 읽히나	내 얼굴이 읽히나	0
잘 만나고 있는데 나 질려하면 어쩌지 걱정이야	나 질려하면 어쩌지 걱정이야	0
언제까지 내가 선톡을 해야할까.	언제까지 내가 먼저 카톡 해야 할까.	0
잠 안 온다고 했더니 자장가 불러줬어	자장가 불러줬어	0
이별을 극복하면서 참 많이 힘들기도 했었네.	이별을 받아들이지 못하는 제가 한심하네	1
남자친구가 유학 간대	남자친구가 유학 간대	0
썸남이 오디션 나간대	썸남이 등산 간대	1
썸 타는 중인데 안 설레.	썸인데 안 설레.	0
버스가 안와	버스가 왜이렇게 안오지	0
있잖아	음	1
여자친구가 사진을 너무 많이 찍어.	여자친구가 사진 찍는 걸 너무 좋아해.	0
애매한 관계같아.	관계가 애매해	0
사랑하는데 내가 집착해	내가 그 사람한테 너무 집착해	0
야	응	1
남친이 SNS에 내 사진에 안 올려	남친 SNS에 내 사진 없어	0
재회하고 딱5개월만에 헤어졌네	저 괜찮으면 친구사이 하자는데	1
남자친구가 다른 여자들에게 인기가 많아.	남자친구가 여자들한테 인기가 너무 많아.	0
잘 지내?	잘가	1
친절한 너에게 	하루가 너무 길다	1
혼자만의 시간을 갖고 싶어	혼자만의 시간을 갖고 싶어	0
같이 있으면 좋을텐데	같이 있고 싶다.	0
의욕이 안 생기는데 자꾸 하래	의욕이 하나도 없는데 하라고 하네	0
군대간 오빠한테 손편지 하려고	비오는 소리 들리니까 그 사람 생각나	1
이제는 이별을 받아드리려고 합니다	이제떠나려합니다	1
심각합니다.	심장이 주저 앉은듯 합니다	1
썸이 좋아	썸이 좋아	0
직장에서 화풀이 대상 같은데 그만둬야 할까?	직장에서 자꾸 혼나는데 그만둬야할까?	0
내일 만나자고 데쉬?	내일 만나자고 해볼까?	0
아무리 힘들어도, 밥은 먹히더라구	아직 준비가 안됐는데.	1
숨막히네	스타트업하면 위험할까	1
드라마보고 눈물났어	딱 오늘 새벽 헤어졌습니다.	1
헤어지고 4달째	헤어지고 다시 만나고 하다 결국 이별	1
남자친구 조건 때문에 헤어졌어.	남친과 헤어진지 12일째.	1
권태기 이별	그 모습 자꾸 생각나	1
막차 놓쳤다 택시비 아까워	막차 놓쳤다	0
좋아하는 애랑 있으면 왜 쳐다보지를 못하겠지.	좋아하는 애랑 있으면 왜 쳐다보지를 못하겠지.	0
진짜 어의 없네.ㅠㅠ	진짜 잊혀질까?	1
6개월간의 짧은 사랑.	6년 4개월동안의 연애. 그 후 이별 뭘해야할까	1
오늘도 짝사랑하는 남자 땜에 우울해요.	짝사랑하는 남자 땜에 우울해요.	0
2년동안 나 사랑해줘서 고맙다	2년여의 만남 사랑해 고마워	0
실망 안시키면 좋겠다	실망하지 않았으면 좋겠다	0
너를 사랑한 시간	너를 사랑한 시간들	0
여자친구가 잘못된건아닌데 표현이 너무 서툴러.	여자친구가 표현이 서툴러.	0
제 마음과 머리가 일치가 안되.	제가 그녀를 놓아줬어.	1
이렇게 못 알아 듣니	말을 왜 이렇게 못 알아 듣니	0
용서의 의미	우리서로 애써봐	1
레고 사고 싶은데 비싸	레고가 비싸	0
사랑이 구체적으로 뭐야?	사랑이 뭐야?	0
나는 잘 할줄 아는 게 없는 것 같아	할줄 아는 게 없어	0
죽어도 아무도 모르겠지	내가 죽어도 모를 거 같아	0
살빼고 담배 끊고 다 했는데!!	나 남자인데 상담좀 해줘	1
여친이 있는 사람인데 왜 나한테 잘해주지?	여친하고 헤어진지 얼마 안됐는데 딴 사람 좋아하게 됨.	1
잡담할 시간 있어?	잡담해도 돼?	0
능력이 너무 안돼	내 능력이 너무 모자라	0
고양이처럼 도도한 여자친구	썸인데 너무 친한척해	1
보통의 이별통보가 아닌	부디 돌아와	1
멍 때리기	멍 때리는 중	0
내 편이라고는 하나도 없는 거 같아	내 편이 없는 거 같아	0
사랑하면 예뻐지나봐	사랑하면 예뻐지나봐	0
짝남이 삐딱하게 굴면 어떻게 하죠?	짝남이 삐딱하게 굴면 어떻게 하죠?	0
짝남이 자꾸 꿈에 나오는데 꿈에서도 용기 없어서 피하고 그래.	짝남이 자꾸 꿈에 나오는데 꿈에서도 용기 없어서 피하고 그래.	0
남자친구 코 완전 높아	남친 코가 높아	0
헤어진지 두달	헤어진지 벌써 두달이 다되가지만.	1
잘 먹는 남자가 보기 좋지않아?	나랑 좋아하는 음식 비슷한 남자랑 만나고 싶어	1
이건 뭘까?	왜 이런 말을 했는지 궁금해	1
몰두할 때는 연락 안 되는 사람 어때?	뭔가 몰두할 때는 연락 안 되는 사람 어때?	0
분노감 ㅠ	불륜이 될까봐 정리하려고.	1
신혼여행 한달쯤 가고 싶다	신혼여행 길게 가고 싶다	0
좋다가 밉다가 무한반복	좋은꿈 꿨다 생각해	1
싸우면 전화 꺼놔서 답답해	싸우면 잠수타서 더 화나	0
정말 막장으로 헤어짐	정말 미치겠네	1
남친 어디서 만나	남자친구는 어디서 만나	0
극복 연락 흔들림	기다리고 계신 분들.	1
잘지내나	잘 지내고 있니?	0
시간이 지날수록 더 보고싶어	시원섭섭하지만 후련하네.	1
결혼할 사람이 나한테 거짓말한 거 같아	계속 그리워	1
너무 오래 기다리게 한다.	나를 너무 오래 기다리게했어	0
연락은 괜히 해서	연락하고 싶어	1
귀가 윙윙거려	귀 아파	0
썸에서 자꾸 끝나요	썸에서 끝나요	0
오늘도 전 여친sns를 봤습니다	오늘도 하염없이 걷고 눈물 흘리고	1
좋아했지만 고백은 못하겠어.	좋아했지만 말 못하겠어.	0
소소하지만 확실한 행복부터 챙겨야겠다.	작은 행복이 소중한 것 같아	0
새 휴대폰이 갖고 싶어	핸드폰 바꾸고 싶다	0
집에서 에어콘 바람이나 쐬자	즐겁게 잘 다녀온 것 같다	1
여자친구가 준 생일 선물이 별로야	여자친구가 준 생일 선물이 맘에 안든다 	0
직장인 되니까 시간이 너무 없다.	주말에 뭐하고 놀까	1
짝사랑 하는 여자가 헷갈리게 합니다.	짝사랑 하는 여자가 헷갈리게 합니다.	0
썸인지 어장인지	썸인지 착각인지	0
명품선물 꼭 해야할까?	비싼선물 꼭 해야할까?	0
개거지같이 헤어져서 열받아	거의 매일 술	1
아직 결혼은 못할 거 같은데 동거해도 될까?	아직 결혼은 못할 거 같은데 동거해도 될까?	0
비타민 사서 먹어야겠다.	비타민 먹어야지	0
밥생각이 없어	식욕이 없어	0
썸인 것 같아	썸 타다가 자연스럽게 사귀는 방법	1
괜찮은 줄 알았는 데	괜찮은 척, 어른인척	0
세상에서 제일 쓸데없는 게 짝사랑 같아.	세상에서 제일 쓸데없는 게 짝사랑 같아.	0
성공할 수 있을까?	참으면 성공할 수 있을까?	0
밤이 더 힘들어	힘든 밤입니다	0
비가 오니 이 노래가 생각 나네	비극.	1
사랑만으로 안되는 게 많을까요?	사랑만으로 안되는 거?	0
면도안하면 안되나	면도하기 귀찮	0
인센티브가 생각보다 안 나올 것 같아	보너스 깎였어	1
썸 끝냈는데 너무 힘들어.	썸타다 끝냈는데 너무 힘들어.	0
최악의 소개팅이었어	최악의 소개팅이었어	0
끝이 났네	끝인가?	0
기분 울적해서 좀 걷고 있어	울적해서 거리를 걷고 있어	0
기숙사로 들어가서 사는거 어떨까?	기숙사 살면 아무래도 불편할까	0
오늘은 샐러드만 먹어야지	샐러드 먹어야지	0
그 사람은 나한테 관심이 없는걸까?	그냥 결혼이나 할까?	1
괜찮은 사람인지 어떻게 알 수 있을까?	괜찮은 거 같은데 아니면 어쩌지	0
자주 못보면 헤어지겠지?	몸에서 멀어지면 맘에서도 멀어진데	0
상사가 미워	상사가 미울 때	0
남친과 살아온 환경이 너무 달라	남친과 내가 환경이 너무 달라	0
다 내려놓고. 오늘부터 연락 끊었네.	다 정리된 상태에서 헤어지면 후폭풍 없나?	1
멋진 삶을 살고 싶어	멋지게 살고 싶었는데	0
내아파트 갖고 싶어.	아파트 사고 싶다	0
애를 나혼자 키우는 것 같아	아무 말이나 하면서 시간 때우자	1
이별하고 절대 하지 말아야할 것	이별한지 10일차 점점 나아지고 있습니다.	1
SNS 를 끊어야 하는데.	가슴 아픈 이별	1
사람들이 날 너무 힘들게 한다.	사람에 치여	0
사랑보다 조건을 보고 결혼해야할까?	조건 조으면 결혼해야 할까?	0
남자친구가 sns에 나 안 올려.	남자친구가 플필에 내 사진 안 올려.	0
결혼 준비 할 게 많아	결혼하는데 돈 너무 많이 들어	1
새신발 샀는데 비와	새신발 신었는데 비와	0
헤어진지 1주일 되었습니다	헤어진지 2주만에 만났어	1
좋아하는 사람 앞에서 성격이 이중적인데 정상인가요.	좋아하는 사람 앞에서 성격이 이중적인데 정상인가요.	0
질긴 사랑과 아픔의 정도	집착같아	1
현재를 즐기면서 살고 싶다.	즐기며 살고 싶어	0
지금 필요한 건 비난보다는 위로 아닐까	개념이 없는거지~	1
좋아하는게 이렇게 힘들지 몰랐어.	좋아하는게 이렇게 힘들지 몰랐어.	0
야구장 고고	야구장이나 갈까	0
야채 더 먹어야지	야채 좀 더 먹어야겠다.	0
베프랑 싸움	친한 친구랑 싸움	0
제길	제일 짜증나는게뭐냐면 문자로 헤어졌다는 거야	1
말 없이 찾아가는건 예의가 아니겠지.	말 없이 가는건 예의가 아니지.	0
어떡하냐 	어쩌면 좋을까	0
방탈출 게임 갔다왔어.	방탈출 게임 했어	0
빨래 다했다.	빨래 끝	0
도와줘.	돌이키기 힘든 실수	1
남자친구가 의심해	남자친구가 나 안 믿어줘	0
집들이는 보통 누구를 초대하나?	집들이 누구 초대해?	0
친구 몇 명쯤 필요한가	진짜 친구 몇 명 있어야 돼?	0
동호회 재미 없어졌어	동호회 나가지 말까	0
나 둘다 좋아하는 것 같애	나 사랑할 준비 됐나?	1
길은 멀고 해는 진다	산 넘어 산이네	0
괜찮아지고 있어	긴 시간이 걸렸지만 괜찮아.	0
남자친구가 되어줘.	내 남자친구가 해줘.	0
멀어지는 길.	멘탈이 점점 무너지네	1
오랜만에 아침 먹었어	아침 먹었더니 든든하네	0
사랑이 끝난 거 같다는 느낌이 너무 많이 들어	사랑이 끝난 거 같다	0
5년 가까이 사귄 그녀와 헤어졌습니다.	5년 만난 여친과 결국 헤어졌습니다	0
연애를 못 봐서 그런가 대화를 어떻게 해야할지 모르겠어	대화를 어떻게 시작 해야할지 모르겠어	0
모르는 사람 만나는거 너무 스트레스야	새로운 사람 만나는 게 스트레스야	0
휴 착찹하네	흐앙 . 왤케 자꾸 생각나죠	1
소개받고 맨날 톡하면 썸이지?	소개받고 맨날 톡하면 썸이지?	0
면도 귀찬하	명치쪽이 답답해	1
짝남이 곧 군대를 가요.	짝남이 곧 군대를 가요.	0
씻기 싫어	씻기도 귀찮다	0
콩깍지 왜 안 벗겨지지?	콩깍지 언제 벗겨져?	0
울적해 울고 싶어	마음이 울적해	0
점점 힘들어져	정말 간절하고 간절하네	1
어제 동창회 갔는데 나 걔랑 썸 타는 것 같애.	동창회 갔다가 만난 애랑 썸 타는 것 같애.	0
화나서 좀 울었어.	홧김에 짝남한테 고백했다.	1
일도 하고 공부도 하는게 가능한가?	일이랑 공부 동시에 가능?	0
짝사랑 하는 사람과 친해질 수 있는 방법 조언 좀.	짝사랑 하는 사람과 친해질 수 있는 방법 조언 좀.	0
고백하고 후회하면 어떡하지	얘는 싸우기만 하면 연락이 안돼	1
썸남이 여사친 만나러 간대.	썸남이 다른 여사친 만나러 간대.	0
뭐하냐고 계속 물어보면 좋아하는 거야?	뭐하냐고 자꾸 물어보면 좋아하는 거야?	0
아직도 남았나봐	아직도 이별중인가봅니다.	1
내일이면 헤어진지 2주 되네.	너가 없으면 못 살 줄 알았는데	1
내 머리 속에 지우개가 있으면 좋겠어	내 생각 하나만 바꾸면 편할텐데.	1
너무 화가나 슬프구	너무 힘든데	1
결혼 했어	결혼 했는데.	0
차 렌트 해야겠다	렌터카 빌릴까봐	0
사랑이 뭐라고 생각해?	사랑이 뭐야?	0
게임 같이 하자고 할까?	같이 게임하자고 해도 되나?	0
헤어진 지 이틀됐네. 붙잡으면 안되겠죠?.	헤어진것인가 아닌것인가	1
썸 타는 사람한테 영통 걸까?	썸 타는 사람한테 영상통화 걸까?	0
좋아하는 애가 여친 사귈 마음이 없대.	좋아하는 애가 여친 사귈 마음이 없대.	0
여자가 먼저 고백하는 거 어때?	여자가 먼저 고백하는 거 이상해?	0
남자는 먼저 고백하면 관심 사라짐?	남자는 여자가 먼저 고백하면 관심 사라짐?	0
어제 만났네.	어제 연락햇는데ㅋㅋ	1
공부로 먹고 살 수 있을까	계속 공부해도 될까	0
술 뭔지 알아.	술 알아?	0
졸린데 못 자겠어.	졸린데 잠이 안 와	0
젊게 살고 싶다.	젊어지고 싶어	0
에공 넘 춥다	너무 추워	0
남친 투정이 심해	남자친구 요즘 투정이 너무 심해	0
방학이 끝났다니	개강이라니	0
서로에게 맞추려고하는데 잘 안돼	맞추려고 하는데 잘 안돼	0
첫이별 너무힘드네 ㅠㅠ	최저임금 수준에서 알바비가 안 나왔어	1
오늘은 쉬고 싶다	오늘 그냥 쉬고 싶다	0
헤어졌는데도 좋아하는거 별로임?	헤어졌는데도 좋아하는거 별로임?	0
헷갈리는데 유지하는 게 좋을까	헷갈리는데 어떻게 하는게 좋을까	0
점점 기대하게 되네	기대돼	0
노는게 제일 좋아	맨날 놀기만 했으면 좋겠어	0
좋아하는 애가 연예인에 관심이 많은데 나는 관심이 없는데 무슨 얘기하지?	좋아하는 애가 연예인에 관심이 많은데 나는 관심이 없는데 무슨 얘기하지?	0
일 하면서 공부도 하면 힘들겠지.	일이랑 공부 동시에 하려니까 걱정 돼.	0
수도가 얼었나 물이 안나와	수도가 얼었나봐	0
저도 연애하고 결혼할 수 있을까	전 기다리고 있어.	1
3개월째	3년 연애 . 마침표가 도저히 끊기질 않네 어쩌면 좋죠	1
제자리 지키기.	조금만 사랑할걸	1
내 마음을 나도 모르겠어	아 어떻게 해	1
짝사랑을 끝내니까 마음이 허전해.	짝사랑을 끝내니까 마음이 허전해.	0
꿈에서 자꾸 어떤 여자애가 나와	어떤 여자애가 꿈에 자주 나와	0
핸드폰 고장난거 아니야 연락이 안와	폰이 문젠가	0
쉽지 않겠지만.	슬퍼죽겠습니다	1
퇴근 시간도 아닌데 엄청 막혀	퇴근길 아닌데 차 엄청 막혀	0
나 좋은 사람 만날 수 있을까?	좋은 사람 만날 수 있을까?	0
마지막 붙이지 못한 이별편지	마지막 정리	1
언제 과제 다 하냐	성장한다는 느낌이 없어	1
1년만에 다시헤어지게 됐네	1년이 되어갑니다	1
일에 적응하면 좀 더 잘 할 수 있을까 	회사 적응할 수 있겠지?	0
카카오톡 계정 탈퇴	카톡으로 사진을 보내왔어	1
훅 들어온다.	다가오지마	0
첫사랑 생각나는데 연락 해볼까	요즘 첫사랑 생각나는데 문자 해볼까	0
결국 또 오게되네	결국 연락했어	1
부자로 태어 났으면 좋을 텐데	금수저 물고 태어나면 좋겠지?	0
매일 아침 정류장에서 마주치는 여자애한테 눈이 가.	아침마다 버스 정류장에서 마주치는 여자애한테 눈이 가.	0
지하철만 타면 생각나	진짜 미치겠다	1
오늘도 사랑해	사랑해	0
깡 마른 거 같아	너무 마른 거 같아	0
시간이라는게 참 사람을 무색하게 만들죠	신나게 산책했습니다	1
떠나려는 사람 잡는 방법	또 다시 낮술	1
하객룩으로 뭐 입지?	하객룩으로 뭐 입지?	0
무슨 생각 하고 있을까?	누구 생각 하고 있을까?	0
자주 가는 카페에 알바생한테 번호 따고 싶은데	자주 가는 카페에 알바생한테 번호 따고 싶은데	0
살며시 다가왔어	나도 모르게 살며시 다가왔어	0
청첩장 누구한테 줘야할지	청첩장 누구 주지?	0
내 마음에 마지막 인사	내 사랑은 그저 집착일 뿐이다.	1
약속 끝나고 짝녀를 집에 데려다주면 너무 티나려나?	짝녀를 집에 데려다주면 너무 티나려나?	0
사는게 날 너무 지치게 해	삶에 지쳤어	0
고민이 많아	추억이 담긴 사진을 지웠습니다	1
이별 하루차를 보내고 있습니다	이별 후 첫날	1
전여친이랑 낼 술한잔 하기로 했어	점심시간잠깐 그녀가 저에게 했던 말들이 떠오르네~ㅠㅠ	1
친구 예전 남자친구 사귀어도 되나	친구 전남친 사겨도 되나	0
올해 이상해	올해 왜 이러지	0
퇴근하고 싶다.	퇴근시간만 기다려	0
그런 친구 아니었는데 너무 귀찮게 하네	친구가 귀찮게해	0
나 결혼할 수 있을까	고양이 키우고 싶어	1
답하기 싫은가봐	답이 안와	0
마딩 있는 주택에 살고 싶어	단독주택 살고 싶어	0
이젠 놓아줘야 할 때인가 보다	이젠 어떡해얄지 모르겠어	1
지는 거 좋은 사람은 없겠지	지는 거 싫어	0
오늘 하루도 이렇게 마무리	오늘도 끝	0
비혼주의자인데 만나도 될까?	비혼주의라는데 사귀어도 될까	0
걔한테 잘보이고 싶은데 무슨 옷을 입는게 좋을까?	같이 있자고 말해도 될까?	1
사랑때문에 많이 아파	사랑 때문에 아파	0
아프면 안 되는데	올해도 건강하길	0
왕따된 거 같아	친구들이 나만 왕따시키는 거 같아	0
서비스센터 가야겠네	서비스센터 가야하게 생겼네	0
나를 좋아하는건 바라지도 않아요.	사랑 같은 건 바라지도 않아요.	0
헤어졌네	헤어졌다는 그 말.	1
우산 또 안가지고 왔다	우산 또 놓고 왔어	0
결혼하는데 준비할 게 많네	결혼하는데 왜 이렇게 할 게 많아	0
전화 왜 안오지	벨이 울리는 걸 기다려	0
짝남이 독서가 취미라는데 무슨 책을 선물해줄까?	짝남이 독서가 취미라는데 무슨 책을 선물해줄까?	0
컴퓨터가 넘넘 느려	컴퓨터가 느려졌어	0
저만 좋아하는 사람 페북 같은거 살펴보나요?	페북 그만 해야 되는데 자꾸 보게 되네	1
헤어지는 중입니다	헤어지면 연락 안하는게 맞을까	1
이상형 알고싶다	이상형 궁금해	0
여친과 갈 때까지 가면 질리나	여행이라도 가고싶다	1
심난한 하루	싱숭생숭ㅠ	0
내가 제정신이 아니다	요즘 제정신이 아니야	0
기프트콘으로 선물받았어	기프트콘 선물받았어	0
우아하게 화내는 법	화내는법을 모르겠어	0
그의 환심을 살 수 있을까?	환심을 살 수 있을까?	0
부모님 반대로 헤어졌습니다	불금에 혼자 혼술	1
이별후 3일째	이별후 느끼는 감정들이 단계별로 있는거 같네	1
썸과 사귀는것의 차이	연애 중인데 불안하고답답함 왜일까요	1
얼굴보고 정리하려했는데 안돼.	헤어진다는게 나한테도 오네	1
시간을 돌리고 싶네	시간이갈수록	1
짝녀 연락 끊긴지 꽤 됐는데 연락해도 될까요?	짝녀 연락 끊긴지 꽤 됐는데 연락해도 될까요?	0
내가 참 못난거 같아	친구가 다 떠나서 내가 못났나 싶어	0
내가 좋아하는 애가 유학간대.	내가 좋아하는 애가 유학간대.	0
똑똑하면 좋겠다	똑똑해지고 싶다	0
4년 연애 중	4년째 짝사랑 중인 나 이제 고백해도 될까?	1
카드 다 부러뜨려 버려야겠다.	카드 다 없애버려야지	0
거리가 먼데 고백하면 받아줄까?	걔 앞에만 서면 말이 안 나와	1
외향적이면 좋을텐데	활발한 성격 갖고 싶다	0
공시 준비 힘들어	공시 준비하는데 힘들다	0
짝녀가 저한테 관심이 없는 것 같은데도 계속 연락해도 될까요.	짝녀가 저한테 관심이 없는 것 같은데도 계속 연락해도 될까요.	0
손가락이 예쁜 사람	손가락이 가늘고 긴 사람	0
습관은 못 고칠 것 같아.	한 번 길들인 습관은 고치기 어려워	0
느낌이 좋아	느낌이 왔어	0
과일 잘 안 먹게 돼	과일 안 먹게 돼	0
눈물 나서 못 멈추겠어	갑자기 눈물 나	0
기념일에 선물 어느정도로 해줘?	기념일 선물  얼마나 드나?	0
술집에서 헌팅했어	오늘 술집에서 헌팅했어	0
나랑 썸타는 애가 영화보재.	썸타는 애랑 드디거 영화보러 가기로 함.	0
남친 때문에 살찐 듯	연애했더니 살찐 듯	0
나 내일 기숙사 가야돼	내일 기숙사 들어가	0
장난 잼있어	장난치니까 좋다	0
맘 정리했는데 연락오는데.	맘 정리했는데 연락오는데.	0
일요일에 어디 가고 싶어.	일요일에 교회만 가	0
뭔가 새로운 자극이 필요해	자극이 필요해	0
덤덤	아무 것도 도움이 안된다	1
숨어서 보기.	슬퍼, 그리고 아려	1
아직도 잊지 못했는가봐	아직은 아닌것 같은데	1
썸 탈 때 연락문제로 속상한 적 있어?	썸 탈 때 연락 문제로 속상한 적 있어?	0
첫사랑과 헤어졌습니다.	카카오톡 대화명	1
내려놓는다는건 어떻게 하는거죠	내일 마지막 데이트	1
빠삭한 후라이드 치킨 먹고 싶다.	치맥이 정답	1
많이 늦은시간인데 연락해봐도 괜찮을까?	늦은 시간인데 연락해도 괜찮을까?	0
동심의 세계로 들어갔다 온 거 같아	나도 동심의 세계로 빠져들다	0
사람들이 나를 너무 힘들게 한다.	사람들 때문에 힘들어	1
친척들 만나기 싫다	친척들 만나는 거 싫어	0
마음이 불안하고 초조해 미치겠어	마음이 쫌 복잡하네	1
기억의 왜곡에 속지말고 아파하지 마세	기절할 정도로 피곤해야 잠드는데	1
잊어보려 하는데.	잊은 줄 알았는데	1
여자친구랑 종교 때문에 다툼	여자친구랑 종교가 달라	0
춘곤증인가봐 졸려	춘곤증인가	0
친구같은 연애 하고 싶어	친구같은 연애 하고 싶어	0
좋아하던 사람 미워질 것 같아.	좋아하던 사람 미워질 것 같아.	0
진짜 이제 안녕	진짜 끝이 보이네	1
어떻게 여러 명을 좋아할 수 있어?	여러 명을 다 좋아한다는거 이상해?	0
질린다네.	집착인걸까.	1
시계 소리가 거슬려	시곗바늘 소리가 너무 크게 들려	0
시간이 휘리릭	시간이 너무 빨리 가	0
왜좋았던 기억만 남을까	왜이럴까 우린.	1
짝사랑 하는 여자에 대한 고민 좀 들어주세요.	짝사랑 하는 여자에 대한 고민 좀 들어주세요.	0
할 줄 아는거!	행복한 돌싱녀	1
가족끼리 여행간다.	가족여행 가야지	0
대출 갚으면 한 평생 다 갈듯	대출 갚다 죽겠어	0
요즘 내가 내가 아닌 거 같아	요즘 내가 내가 아닌 거 같아	0
인사드리러 갔는데 파혼하는게 나을것 같아 	인사드리러 갔다가 파혼했어	0
나 챙겨줄 사람이 필요해	나 좀 건들지 마	0
보면 설레는게 첫사랑인 거 같아	손발이 굳는 거 같은게 첫사랑인 거 같아	0
짝남 생각할수록 정리 되는 듯.	짝남 생각할수록 정리 되는 듯.	0
내일 더 사랑해	내일은 더 사랑해야지	0
드디어 손 잡음	손 잡았어	0
처음 마음이 아픈게 첫사랑인가	처음 마음이 아픈게 첫사랑인가	0
좋아하는 여자애 앞에서 표정 관리가 안됩니다.	좋아하는 여자애 앞에서 표정 관리가 안됩니다.	0
진심 킬링타임으로 좋다	너무 재밌어서 입벌리고 봤다	1
마지막 짐 갖다주러 가는 길	마지막으로 붙잡아보려 합니다.	1
사랑이 변하면 어떡하지?	안 사랑한다는데 어떡하지?	0
휴대폰이 넘 느려	핸드폰이 느려터졌어	0
제자리걸음만 하는 듯	나만 제자리걸음이야	0
두 사람 잘됐으면 좋겠다.	연결 해줬는데 잘됐으면 좋겠다.	0
빨리 찾아온 사랑	생각보다 빨리 찾아온 사랑	0
짝녀가 예쁜 건 아닌데 끌려.	짝녀가 예쁜 건 아닌데 끌려.	0
치과 치료 받아야 할까	치과 가야 하나	0
심리상담 받았어	싸웠다	1
소개팅 나온 여자애가 너무 좋은데 나만 좋아하는거같아. 어떻게 날 좋아하게하지?	소개팅 나온 여자애가 너무 좋은데 어떻게 날 좋아하게하지?	0
동거하다 이별	두달간에 연애 그리고 헤어짐	1
너무 힘들다	너무 힘들어서 지금 옥상에 올라왔어.	1
군대 가도 기다리겠다더니	궁금한게있어!!	1
반 배정 내가 원하는 대로 될까	반 배정 좀 잘 됐으면 좋겠다	0
나 열심히 할거야	진짜 열심히 해야지	0
꿈이 이루어질까?	꿈이 현실이었으면	0
짝녀와 자연스럽게 친해질 수 있는 방법 좀.	짝녀와 자연스럽게 친해질 수 있는 방법 좀.	0
돈 없어	돈이 없네	0
너무 힘이 듭니다	너무 우울해	1
강아지 키우고 싶어	강아지 키울까	0
너무 사랑해서그래서 미안하다	너무 아플줄 알았는데 오히려 무덤덤하네	1
헤어지자	헤어지자고 말할까	0
취직하면 끝이 아니네.	취직하면 끝일줄 알았는데 계속 할게 많아	0
홈쇼핑에서 자꾸 사게되네	홈쇼핑에서 또 샀어	0
멘탈이 많이 흔들리네	면접 잘 볼 수 있을까	1
정말 오락가락 언제 괜찮아질지	정말 잊은걸까?	1
친구의 구남친을 좋아하게 됐어요.	친구의 구남친을 좋아하게 됐어요.	0
이별 이야기	이별 이야기	0
커피 좀 마셔야겠다.	커피 마셔야지	0
그리워 하지마 만약 다시 만난다면 넌 더 외로울거야	그사람도 아주 가끔은 내 생각해줬으면 좋겠어	1
친구 많이 사귀고 싶어	친구 사귀고 싶어	0
밥 먹었어?	너는 뭐 억었어?	0
오늘도 톡을 보냈네	오늘따라 너무 연락하고 싶네.	1
좋아하는 그녀가 유학을 간다고 합니다.	좋아하는 남자애 프사가 누굴까.	1
생각할 시간을 달라고 한 남친	서로 그냥 밑바닥을 보여준것 같아	1
콩깍지가 씌었나봐. 아직도 좋아해.	콩깍지가 씌었나봐. 아직도 좋아해.	0
요가 온 아줌마들이 참견해	요가하는데 아줌마들이 참견해	0
어제 정말 사랑한 그녀와 헤어졌습니다.	어제가 극에 달했었는데	1
벌써 그리워지네	화가나 미치겠다	1
처음엔 좋았는데	처음에는 좋았는데 점점 별로	0
위로 해줘	위로의 말 해주세요	1
웃겨봐	원래그런건가바	1
슬픈게 솔직하면 안되는건가?	시간 낭비하지 마세요	1
청첩장을 찍는 날이 오다니	청첩장을 찍는 날이 오다니	0
연애 하고 싶어	달달한 연애 하고 싶어	0
선배가 나만 챙겨줌. 썸인 부분?	선배가 잘 챙겨주는데 그냥 원래 착한 거겠지.	0
이별이 힘든 이유는.	이별준비 그리고 극복	1
신청했더니 정말로 왔네ㅎㅎ	심란하네	1
우리 반 여자애 좋아하게 됨.	우리 반 여자애를 좋아하는데	0
헤어지고 나면 어떻게 살지	헤어져도 살 수 있겠지	0
뭔 희망이 있을까	저에게 희망이 있을까?	0
짝사랑 하는 여자가 헷갈리게 합니다.	짝사랑 하는 여자가 꿈에 나왔어	1
전화를 너무 안 받아	연락이 너무 안돼	0
사랑의 힘은 위대한가봐	사랑의 힘은 위대한가봐	0
연락하면 후회할까	연상녀랑 어제 헤어졋네	1
내 마음을 좀 알아 달라고	내 마음을 알아줬으면	0
버스타면 힘든데 그냥 택시탈까	버스탈까 택시탈까	0
비가 온댄다	비라도 좀 왔으면	1
영원히 함께 했으면 좋겠다	영원히 함께 했으면 좋겠다	0
꿈이 너무 리얼하네	끈을 놓지 말자.	1
숙취 때문에 지끈거려	숙취 장난 아니야	0
휴 결국 헤어졌습니다	휴아플걸알면서도	1
첫사랑 그 긴이별	첫여친이라 잘 안잊혀지네	1
결혼할까	결혼해도 되나	0
너무 추워서 시베리아 같아	시베리아 같아 추워	0
내 생각을 하고는 있을까?	내 자신을 사랑하라.	1
길이 미끄러워서 미끄러질뻔했어	길이 얼어서 미끄러질뻔했어	0
두달 반	두달이 지났네	0
이런게 후폭풍인가.	이럴경우 연락안오겠죠?	1
재회 후 헤어짐.	재회하고싶어	1
힘든 하루 하루 되돌리며	오늘도 힘들다	0
여름인데 태닝할까	태닝할까	0
돈 다 어디 갔나	돈 다 어디 쓴지 모르겠네	0
내가 이 사람을 사랑하는 건가?	내가 이 사람을 사랑하는 건지도 헷갈려	0
다리가 덜덜 떨려	다리가 후덜덜	0
죽었던 연애세포가 살아나는 것 같아.	죽었던 연애세포가 살아나는 것 같아.	0
오늘 데이트각이야.	오늘 데이트할 거 같아.	0
운세 종합해 보니 헤어질 때였네	웃는척 친구인척	1
결정은 빠를수록 좋겠지?	결정은 빠르면 빠를 수록 좋겠지?	0
또 일주일도 못가서ㅎㅎ	또 하루가 간다.	1
왜 나한테 피해를 주냐고 	피해는 주지 말아야되는 거 아니야?	0
소개팅 했는데 에프터 신청도 안하고 연락도 안 와	소개팅한 사람한테 연락이 안 와	0
가스불 켜놓고 나온거 같아	가스불 켜고 나갔어	0
일본어 배우는거 어렵네	한국어 발음이 어렵네	1
죽음을 뛰어넘는 사람	죽음을 뛰어넘는 사람	0
허기져	배고픈 거 같아	0
썸녀랑 거의 사귀는 수준인데 꼭 고백해야해?	회사에서 어떤 사람이랑 자꾸 눈 마추쳐.	1
볼링 치고 놀았어	볼링 치고 옴	0
해선 안 될 사랑.	행복해라 불행해도 좋고	1
무섭다	뭔가 무섭다.	0
좋아하는 애 친구한테 다같이 만나자고 말해도 돼?	좋아하는 애 친구한테 다같이 만나자고 말해도 돼?	0
약 한달 전 헤어진 그에게	어느덧 헤어진지도 4개월이 됐네	1
짝사랑 하는 사람을 보냈습니다. 위로해 주세요.	짝사랑 하는 사람을 보냈습니다. 위로해 주세요.	0
오늘은 집에 있고 싶어	아무 데도 안 나가고 집에 있고 싶다	0
각자 집에 인사드리러 가	갑자기 선을 긋는 사람	1
빨리 일상속으로 돌아가고픈데.	사람 일 죽으란 법은 없겠지	1
정말 아프고 힘드네	정말 이번엔 끝인거겠죠	1
결정을 못 내리겠어. 어떻해	아직 결정 못 내렸어	0
뭔 상황인지 헷갈리네.	뭔지 이제 헷갈리네	0
두고 봐	나두 잘할거야	0
여자친구가 자기 말만하고 내 말은 안 들어	여자친구가 자기 말만해	0
봄이 왔으면 좋겠어	봄날이 기대돼	0
지갑 없어졌어	지갑 잃어버림	0
데이트 했는데 야경이 참 좋았다	남친이랑 남산 야경 구경했어	1
진짜 좋아하면 장거리 연애 가능?	진짜 좋아하면 장거리 연애 가능?	0
너도 썸 타?	너도 썸 탄적 있어	0
공무원 괜찮겠지	공무원이 좋지?	0
휴지도 떨어졌네.	휴지 사야지	0
썸남이랑 뭐하지	썸남이랑 뭐하지	0
슈퍼문이라더니 예쁘다.	슈퍼문이야	0
헤어진 남친이랑 다시 썸타기	헤어진 남자친구랑 썸부터 시작할 수 있을까	0
맞는 선택일까	잘 선택한건지	0
놀러다니기 좋아하는 남자 착하긴한데 나랑은 안맞다고 생각이 들어.	착한데 너무 놀러다니기 좋아하는 남자 안맞다고 생각이 들어.	0
여자친구가 잘 삐져	여자친구가 너무 잘 삐져	0
여기 있으니까 좋다	여기 좋아	0
친구의 남친 좋아하게 된 거 같아	친구의 남자친구가 눈에 들어와	0
좋아하는 사람 때문에 너무 센치하다.	 사람 때문에 자꾸 센치해 진다다.	0
사람은 역시 기억하고싶은것만 기억하나봐	사랑 참 별거없네.	1
이제는그만하고 싶어	이젠 괜찮을 줄 알았어.	1
1년 반.	1년만에 꿈에 나와서 설레게 하네	1
대학 간다고 달라질까	대학 가면 좋겠지	0
여자친구가 좋은데 믿음이 안 가.	여자친구가 좋은데 믿음이 안 가.	0
결혼하면 행복할까?	결혼하면 좋을까	0
학식 이제 물린다	학식 지겨워	0
거짓말 하는 썸남 말해?	썸남이 자꾸 거짓말해	0
그 사람도 내 생각할까?	그 사람도 지금 내 생각할까?	0
자기 전에 통화하면 썸이야?	자기 전에 통화하면 썸 맞지?	0
첫 눈에 반하는게 가능해?	첫 눈에 반하는게 가능해?	0
최저임금 수준에서 알바비가 안 나왔어	저 사람이 왜 자꾸 볼까?	1
상처 좀 안 받고 싶다	상처 안 받고 싶다	0
아직 사귀지도 않는데 의심을 해.	혼자 썸타는 기분이야.	1
이별 극복 방법	이별 뒤.	1
좋아하는 남자가 톡이 늦어.	좋아하는 남자애가 우리 언니를 좋아한대.	1
시원한 냉면 먹고 싶어	냉면 땡긴다	0
세뱃돈 받았어 호호	세뱃돈 받음	0
너무 행복해. 오래갈 수 있을까?	너무 행복해. 오래갈 수 있을까?	0
남자가 화장하는 거 어떻게 생각해	남자 화장하는 거 어때	0
먼저 인사하려고 했는데 짝남이 먼저 인사해줬어.	짝남이 먼저 인사해줬어.	0
다시 사랑에 빠지는 법 	내가 서로 사랑하는 사람이 있다면?	1
내가 좋아하는 애가 날 좋아하는 것 같으면 갑자기 정 떨어지고 뭔가 싫어짐	내가 좋아하는 애가 날 좋아하는 것 같으면 갑자기 정 떨어짐	0
썸 끝내고 싶지 않아.	썸 끝내고 싶지 않아.	0
잘하는거 하라는 데 없어	잘하는 게 뭔지 모르겠어	0
좋아하는 여자한테 관심 없는 척 하는데 잘하고 있는지 모르겠어.	좋아하는 여자한테 관심 없는 척 하는데 잘하고 있는지 모르겠어.	0
양배추즙 최악	양배추즙 맛없어	0
먼저 잘게 잘자	나 먼저 잘게	0
나의 기억은 또 다시 시간을 걷는다.	나하긴 싫고 남주긴 아깝다는 심리인가	1
자는 거 아니겠지?	그냥 자는 거 아니지?	0
근교에 쉴만한 곳 가면 딱일 것 같은데	가까운데 놀러가면 딱 좋을 것 같아	0
화 잘 내는 법	화를 내는 법을 알고 싶어	0
휴대폰 켜면서 기대하는 것 좀 그만하고 싶네	흑역사 제조 완료	1
이 무리에 낀게 잘못인가	무리에 잘못 낀 듯	0
키 이제 안 크나	키 왜 안 크지	0
손톱 정리 좀 할까	네일 할까	0
습관이라는게 무섭네.	습관처럼 생각나	0
마지막으로 이별하려고 만나고 왔습니다.	마지막이겠죠	1
또 꿈에 나와버리네 에휴	또 다시 이별	1
남친이 바람둥이 같아	남친이 아무나 잘해주는 게 바람둥이 같아	0
다시 사랑에 빠지는 법	그 사람에게 예전만큼 사랑을 못느끼겠어요	0
이별 두달째	이별 수순을 밟고 있는 거지	1
문신하고 싶은데 후회할까?	문신하면 후회하려나?	0
피곤한테 또 잠은 안 와.	피곤한테 잠이 안와	0
정말 너무 힘듭니다	정말 모르겠습니다.	1
샤워하는데 창문 밖에서 소리나서 개쫄음	샤워하는데 밖에서 소리나서 쫄았어	0
짝남이 내가 좋아하는 거 알아버림.	짝남이 내가 좋아하는 거 알아버림.	0
카톡 탈퇴하다가 다시 재가입 했는데	카톡프사 무슨 의미일까?	1
이별후에	이시간들 어찌보내야할까.	1
몸이 영 찌뿌둥해	몸이 찌뿌둥해	0
사랑 감정이라는 게 혐오스럽습니다	날 진심으로 사랑하는걸까	0
이별한지 1달	이별한지 3일.	1
몇일만에 또 찾아갔네요	모든게 니멋대로	1
이 노래는 저음이 좋아	저음 멋있어!	0
이별은 다 비슷한거 같아.	이별은 왤케 힘드나	1
짝남이 공시생이면 어떻게 하죠?	짝남이 공시생이면 어떻게 하죠?	0
미치겠네	미치겠습니다	0
헤어짐과 중간에 다시 만남과 갈등.	현실과 타협해야하는 이별	1
엄마가 나만 시켜	엄마가 나만 시켜	0
이 회사는 나만 일하는 것 같아	직장에서 나만 일 시켜	0
한달 째	한달이 10년 같은.	1
썸타는 애랑 노래방 가는데	썸타는 애랑 노래방 가는데	0
남자친구가 카톡 답장이 너무 느려.	남자친구가 카톡 답장이 너무 느리게 와.	0
엄마한테 차별받고 있는 느낌	엄마가 차별하는게 제일 싫어	0
주말에도 헬스하러 많이 오네.	주말인데 헬스장에 사람이 많네	0
좋아하는 남자 때문에 너무 기분이 안 좋아.	좋아하는 남자애가 날 좋아하게 하려면 어떻게 해?	1
썸인지 아닌지 확인하는 방법 있어?	썸인지 알려면	0
내가 뭘 잘못했을까	내가 잘못했다는데 뭔지 안 알려줘	0
하. 며칠 괜찮아졌다가 후폭풍이 또 밀려오네.	하루가 일년같아	1
헤어짐 통보후 한달만에 연락이 왔는데	헤이진지 이제 딱 한달	1
결국은 무너졌네	결혼 직전 이별	1
약속 끝나고 짝남에게 집에 데려달라고하면 오해하려나?	짝남에게 집에 데려달라고하면 쫌 그런가?	0
간만에 쇼핑 중	오랜만에 쇼핑	0
커피 중독인가	커피 안 마시면 일을 못해	0
짝녀한테 영화 보자고 그냥 해볼까.	짝녀한테 영화 보자고 그냥 해볼까.	0
와인 한잔 짠~	와인 마실까?	0
청강이라도 해야겠다.	청강하려고	0
소개팅할 때 밥값 어떻게 내	소개팅 상대 맘에 들었으면 좋겠다.	1
친구도 아니고 사귀는 사이도 아닌 애매한 사이가 싫어	너무 심각한 사이는 무거워서 싫어	1
추천 메뉴	뭐 먹지?	0
정든다.	수다떨다 보니 정든다	0
내가 해본 연애 중에 짝사랑인데 이뤄진 연애는 없는 듯.	짝사랑인데 이뤄진 연애는 없는 듯.	0
환승 이별이란게 이런거구나	환승역 지나쳤어	1
만나도 불안하면 어떡해?	만나도 불안해	0
곧 500일을 앞두고 헤어졌어.	공허함이 크네	1
어떻하죠? 이 상황을	어제 결국 또 톡보내버렸네,	1
잊기위해 무던히도 노력했는데	잊어야겠지	1
진심이 뭘까?	진심이 뭘까?	0
피어싱하면 아플까	피어싱 할까?	0
남자친구가 날 예뻐해주는 게 느껴져	남친이가 예뻐해주는 거는 알겠어.	0
화장 지워야 하는데 졸려	화장 지우고 자야하는데	0
드레스룸 있으면 좋겠다.	드레스룸 만들고 싶다	0
직장이 괴롭다	직장에서 너무 괴롭혀	0
전 바보입니다.	전 여자친구한테 남자가 생긴 거 같아	1
딱 한달 됐네	한달됐어	0
아무말이나 막했어	말조심해야지	0
단톡방에서 내 톡에만 답장해. 썸 각?	데이트는 어디로 가?	1
그녀 생각에 아직 잠을 잘못잡니다	그녀가 많이 힘들어보이네	1
좋아하는 사람 생각으로 아무것도 집중을 못하겠어.	그 사람 생각으로 집중을 못하겠어.	0
정신 차려야 하는데	정은 많지만 설렘이 없다는 이유로 헤어졌습니다.	1
짝남이 내가 좋아하는걸 1도 몰라.	짝남이 내가 좋아하는걸 1도 몰라.	0
엄마 밥 생각나	엄마 밥 먹고 싶다	0
결혼은 타이밍인가?	시기가 되면 결혼하는건가	1
썸 탈 때는 설렜는데 사귀면 마음이 식을까?	썸 탈 때는 설렜는데 왜 사귀니까 식을까?	0
내가 좋아해도 될까?	내가 좋아해도 될까?	0
좋아하는 사람한테 거절 당할까봐 두려워.	좋아하는 사람한테 거절 당하면 영영 끝일까 두려워.	0
열심히 한 거 같은데 망	열심히 한 거 같은데 결과가 왜 이러지	0
여리여리한 여자가 이상형이래	여리여리한 여자가 이상형이래	0
소개팅 성공하는 방법 좀 알려줘	소개팅할 때 상대방 마음에 들게 하려면?	0
데이트코스 추천	데이트코스 어디가 좋을까	0
어린 시절로 돌아가고 싶어	어렸을때로 돌아가고 싶어	0
요즘 뉴스가 재미가 없네	뉴스 재미없어	0
아직도 가슴이 아프고 눈물이 나네	아직도 눈물 나	0
나란 놈	난 정말 안되겠다	0
사랑한다고 말해주면 뭐가 덧나나	사랑한다고 말해주면 안되나	0
다썸이 뭐야?	데이트 장소	1
부모님 말 안듣고 반항했어	부모님한테 반항했어	0
여자친구가 수상해	여자친구가 수상해	0
완벽한 사람이 되고 싶어	완벽해지고 싶어	0
오늘이 일주일이네.	오랜연애 환승이별	1
샌드위치 생각 나	샌드위치 먹고 싶어	0
괜찮아 지지가 않아	괜찮았었는데	1
여자친구가 너무 어린거 같아.	여자친구가 너무 어린거 같아.	0
일때문에 스트레스 받아.	스트레스 받는다. 일 때문에.	0
헛소리하네	진짜 되도 않는 소리하네	0
너 말투가 마음에 안 들어.	말이 이상해	0
트래킹 하러 갈까?	등산할까	0
썸일까?	썸인 건가?	0
많이 먹었는데 몸무게 똑 같아	살이 안 쪄	0
포근포근한 이불에서 못나가겠어	부드러운 이불에서 나가기 싫어	0
명절 연휴 막막하네.	몇일 동안의 나의 이야기.	1
교통사고 났었어.	교통사고 당했어	0
그녀도 나를 좋아하는 줄 알았는데 아닌가봐.	나를 좋아하는 줄 알았는데.	0
나 좋아하는 남자애 없나봄. 넘 외로워.	요즘 외롭다	0
오늘도 짝사랑하는 사람을 만나러 갑니다	오늘도 잠을 못이루네	1
좋아하는 여자한테 남친이 있는데 연락하고 싶어.	좋아하는 여자한테 남친이 있는데 연락하고 싶어.	0
책만 보면 졸려	책만 펴만 잠와	0
좋아하는 사람이 좋아하는 것들 따라하게 되는데 정상인가?	좋아하는 사람이 좋아하는 것들 따라하게 되는데 정상인가?	0
그 시절엔 다 그랬지	그땐 그랬지	0
상견례는 어디서 해?	상견례는 보통 어디서 해?	0
아름다운 이별은 없겠지	아름다운 이별은 없겠지	0
잠이 안 와	밤에 잠이 안 와	0
이상한 사람이 자꾸 쳐다봐	모르는 사람이 자꾸 쳐다봐	0
좋아 죽을거 같아	생각만해도 좋아	0
내가 싫대	내가 잊어야 그 사람이 날 그리워하는 날이 온다	1
좋아하는 사람이 너무 냉정한데.	좋아하는 사람이 너무 냉정한데.	0
내 이상형이 아닌데 그 남자를 왜 이렇게 좋아할까.	내가 싫은 건 너도 싫어해줘서 고마워	1
축구 가야 되는데	축구하러 가야지	0
술 먹고 카드 긁었어	술 먹고 카드 너무 긁었어	0
좋다고 했는데 아직은 혼자가 더 좋다고 하네.	좋다고 했다고 퇴짜 맞았어	0
며칠 잠잠하다가 또 흔들리네	명절 너무 힘드네.	1
카메라 샀어	비싼 카메라 샀어	0
끝이났네	끝인거겠죠?	0
말하는게 재밌어!	만담꾼이네!	0
썸남 태도가 맘에 안들어	썸남 태도가 영 맘에 안들어	0
오빠 최고라고 해주던 너	올릴까 말까 하다가 조언을 얻고자 올려봅니다.	1
다른 학과 간다	전과했어	0
참 앞 뒤 모르고 제3자라고 지껄이는.	참고 있어.	1
참 알차게 하루를 보냈다.	엄청 돌아다니니까 하루 다 갔어.	1
짝녀랑 저녁에 보기로 했는데 연락두절임.	짝녀랑 저녁에 보기로 했는데 연락두절임.	0
보고파 보고싶어	보지말걸 차라리	1
조금만 기다려 줬으면 좋겠다	나를 기다려줬으면 좋겠다	0
애니 좋아하는 남자 별로임?	애니 좋아하는 남자 별로임?	0
이제 이별한지 한달	이제 점심시간에도 너에게 카톡을 할 수가 없구나.	1
교양 듣는데 어떤 남자가 자꾸 쳐다 봐. 관심 있는 걸까?	왜 쳐다 보지 관심 있나	0
짝녀와 같이 드라이브갈껀데 어디로 갈까?	짝녀와 같이 드라이브갈껀데 어디로 갈까?	0
카드 값 너무 많이 나왔어	카드 너무 많이 썼다.	0
교회 오빠한테 눈이 가	교회에 좋아하는 오빠가 생겼어.	0
사랑한다는 말 쉽게 안 나와	사랑한다는 말이 안 나와	0
이제는 정리가 된 거 일까?	이제서야.	1
저녁 정말정말 맛있게 먹었어	저녁 맛있었어	0
사랑받고 있지 않은 거 같다	사랑받는 기분이 안 들어.	0
팔베개하고 자다가 팔 저린데 말해야겠지?	팔베개하고 자다가 팔 저린데 말해야겠지?	0
오늘 간신히 참았어	오늘 더 힘이 드네	1
남사친이랑 사귀는 거 가능?	남사친에서 사랑하는 사람으로 사귀는 거 가능?	0
여자친구가 바쁜걸 이해못해	여자친구가 바쁜걸 이해못해	0
우정이란게 뭘까	술만 먹으면 전화를 안 받아	1
일본어 어렵네	한국어가 어렵네	1
웃는게 웃는게 아니네	월욜부터 힘드네.	1
결혼까지 생각했는데.	계속 맴돈다.	1
원래 남자친구 집에 놀러가면 청소해주나?	위로노래	1
거짓말을 하게 돼	거짓말을 나도 모르게 자꾸 해	0
오늘 밤 풍경 굿굿	오늘 저녁에 약속 잡았어.	1
남자 친구가 바래다 줬어	남자친구가 데려다줬어	0
누구 소개 좀 시켜줘 봐봐	소개팅 시켜줘	0
매일 술	머 좀 물을게	1
대만 놀러가고 싶어	대만 여행가고 싶어	0
진심으로 사랑하는 여자와	진심으로 사랑하는 여자와	0
또 아픈 밤이네	또 주말이 지나가고	1
가사가 내맘같아	가슴이 너무 아프고 숨쉬기가 힘드네	1
정규직 입사 될까	정규직으로 취업할 수 있을까	0
이별 준비	이별 하는 중	1
숙제 까먹었다.	숙제 안 한 듯	0
조바심 나네	좀 짜증나네	1
스드메 계약했어	스드메 한꺼번에 계약했어	0
일이 잘 안 늘어	일을 해도 안 늘어	0
공책 필기 나만 힘들어?	공책 필기 나만 힘들어?	0
정말 다시돌아 온다면	정말 미안하다 말밖에는	1
아무도 모르게 있고 싶어	조용히 있고 싶어	0
무한리필 가면 너무 돼지처럼 보일까	무한리필 괜찮지 않아?	0
좋아하면서 너무 싫어.	좋아하면서도 너무 싫은 감정 뭘까요.	0
일하는 곳 근처 가서 염탐하고 왔네.	잊고싶다	1
술이 보약도 아니고	술 한 잔 했어	1
삼십대를 훌러덩~~~~	상상했던 미래엔 항상 그가 있었는데	1
남자친구가 너무 소심해	남자친구가 너무 소심해	0
이번 주말 그녀에게 연락해 볼까?	이번 주말 그녀에게 연락해 볼까?	0
한 사람만 죽을 때까지 사랑하는 게 가능할까?	죽을 때까지 한 사람만 사랑하는 게 가능할까?	0
확실한 건 뭘까?	가장 확실한 건 뭘까?	0
썸인데 자꾸 외롭다고 해	썸인데 외롭다고 해	0
몇년째 이별인지	몇일동안 고민하다가 찾아갔습니다.	1
회사에서 마음 편한 사람이 없어	회사에서 마음 놓고 말할 사람이 없어	0
전남친에게 연락왔어.	전여친 남자 생겼나 봐	1
남친에 대한 불신이 자꾸 들어	남친 자꾸 불신하게 돼	0
좋아하고 있는 애를 친구가 소개 시켜줬어.	좋아하고 있는 애를 친구가 소개 시켜줬어.	0
반년만에 연락해봤네	밤만 되면 너무 힘드네.	1
헤어진 후 거의 세 달이 되어가네	헤어진다는게 이렇게 힘든 일인줄 몰랐네	1
썸이었는데 차갑게 대해	썸인 줄 알았는데 싸늘해	0
위로가 되는 좋은글이 있어 올려	으휴 집에 들어가기가 싫네	1
알뜰폰 샀어	알뜰폰으로 바꿨어	0
동네 친구랑 썸 괜찮을까	친구였는데 썸 타는거 괜찮을까	0
모공 점점 커지는 것 같아	모공 너무 커	0
맨날 짝사랑만 하다가 끝났는데 연애할 수 있을까?	늘 짝사랑만 하다가 끝났는데 연애할 수 있을까?	0
아직 보내지 못한 이별편지	마지막이라니 울고 싶다.	1
다시 만나자면 만나줄까	다시 붙잡고 싶은데 돌아올까.	1
여자가 더 사랑해서 한 결혼	여자가 더 사랑해서 한 결혼 어떤가	0
짝남이 몇일째 카톡 안읽씹하면 노답이죠?	짝남이 몇일째 카톡 안읽씹하면 노답이죠?	0
별 보러 시골 가고 싶다	별 보러 가고 싶다	0
동기는 진급하는데	동기가 나보다 먼저 진급	0
이별의 아픔이란	이별이 있어야 인연도 있는거 같아.	1
어젯밤에 판도라의 상자를 열어버렸네	어찌해야 될까?	1
친구 몇 명쯤 필요한가	진짜 친구 몇 명 있어야 돼?	0
썸 타는 사람 만나기로 했는데 뭐 입어?	썸 타는 사람 만나기로 했는데 뭐 입고 나가지?	0
썸남이 같이 운동하자는데 가능?	썸남이 같이 운동하자는데?	0
상 받을 거 같아	나 상 받는대!	0
내가 작아보여.	내가 정말 작게 느껴져.	0
오늘은 내가 기분이가 좋아	오늘 기분 좋아	0
이별 2달째에 새로운 소개팅했습니다.	이별 5일째	1
원피스 입을까	원피스 입는 게 낫겠지	0
남자친구와 여사친이 너무 친해	남자친구한테 정 떨어진 거 같아	1
어떻게 오래만나지?	오래 만나고 싶은데 비결은?	0
좋아하는 여자애한테 무슨 선물을 줄까?	좋아하는 여자애한테 무슨 선물을 줄까?	0
붙잡는건 정말 아닐까?	비가 오니.울컥하네	1
화해 어떻게 해	어떻게 화해하지	0
사랑없는 결혼생활	나 자신을 사랑하는 방법 궁금해	1
썸녀랑 밥 먹는데 어디가지?	회식 중이라고 하는데 연락이 안돼.	1
사랑이 정말 있을까?	사랑이란게 어딘가 있을까?	0
노래 불러줘	웃긴게 장난없음	1
좋아하는 감정이 나를 슬프게도 해	좋아하는 감정이 나를 슬프게도 해	0
6년째 연애중	5년째 짝사랑 중인데 포기해야 할까?	1
진짜 인간적으로 카톡으로 이별통보	진짜 헤어졌네 결국	1
서로 사랑하면 다 될 줄 알았어	사랑하면 다 될 줄 알았어	0
이별했다	이별한지 딱 한달 째.	1
먹통이야 답답하다	말이 안 통해	0
온다고 했는데 왜 안 오지?	온다고 했는데 왜 안 오지?	0
좋아하는 남자애한테 자연스럽게 연락하는 방법 뭐 있을까.	좋아하는 마음이 안 생길 것 같다고 떠난 남자.	1
취직해야 할텐데	취직 원츄	0
직장이 맘에 든적이 없는 거 같애	직장운 없는 거 같애	0
에휴 후폭풍인가봐	여섯번째 이별이에요	1
사랑 없는 삶은 불행할까?	사랑하는 사람 없으면 불행할까?	0
잠 와	졸려	0
짝남 섞인 술자리 갈 예정.	짝남 섞인 술자리 갈 예정.	0
머리는 이제 완전히 이해가됬네 가슴은아직이지만	머리와 가슴이 따로놉니다	1
의미 있는 일 하고 싶다.	의미 있는 일이 뭐가 있을까	0
부자친구 스트레스	친구네 집이 부자라 우리집에 초대를 못하겠어	0
일어나보니까 침대에서 떨어져 있었어	자다가 침대에서 떨어졌어	0
미치도록 보고싶네.	미친듯이 보고싶어.	0
아이돌이 남친이면 좋을텐데	내 남자친구 아이돌이면 좋겠다.	0
회식 재미없어	회식 좀 그만 했으면ㅜㅜ	0
반갑습니다.	반가워	0
이별한지 한 달이 넘었고 괜찮은 줄 알았는데	이별했네	1
상 받고 싶어	상 받으면 좋겠지?	0
연애 잘하는 사람 부러워	연애 고수 부러워	0
서로가 원치 않았던 이별	성급했던 것 같네	1
썸남한테 표현 못하겠어. 어떻게 해?	표현 못하겠어. 어떻게 해?	0
시험 준비 언제 끝나	시험 준비 빨리 끝났으면	0
짝남한테 감정 소모 안하고 싶다.	짝남한테 감정 소모 안하고 싶다.	0
면접만 보면 돼	면접만 남았어	0
여자친구가 나를 떠날까봐 고민이야.	여자친구가 나를 떠날까봐 고민이야.	0
사랑없이 결혼 가능해?	사랑없이 결혼 가능해?	0
인간의 성향은 변하지 않나 봅니다.	일방적인 통보로 헤어졌습니다	1
그 애 앞에서 말을 잘 못하겠어	그녀는 내가 좋아하는 이 상황을 즐기는 것 같아.	1
비정규직 차별 받는 느낌들어.	비정규직이라고 지금 차별하는건가.	0
어제 이별하고 맘이 너무 아파	어제 헤어진 여자친구 연락 왔다고 글 썼는데 ㅋㅋ	1
학교 재밌으면 좋겠어	학교생활 재밌게 하고 싶어	0
발표 잘 하고 싶어	발표 무사히 끝내고 싶어	0
산다는건 뭘까?	잘 사는 게 뭘까?	0
뭔가 뒷맛이 쓰다	인생이 쓰디쓰다	1
저녁 메뉴 좀 골라줘	저녁 메뉴 추천 해줘	0
우연이 만났는데 운명이 됐어	우연이 운명이 됐어	0
재밌는거 해 줘	놀아줘	0
날 버려달라고	날씨가 좋아서 좋긴한데 또 싫네	1
썸이 왜 깨졌는지 모르겠어	썸이 왜 깨졌는지 모르겠어	0
축가 불러 주기로 했어	축가 불러 주는 친구 결혼식	0
도대체 중간이 없어	중간이 없어	0
블록체인이 왜 이렇게 시끄러워	블록체인이 뭐야?	0
뭔가 배워볼까	뭐라도 배워볼까	0
짝남이 남친이 되었어요.	짝남이 남친이 되었어요.	0
버리기 아까운데 리폼 해볼까	리폼 해볼까	0
고백하고 어색해지면 어떡하지?	고백했다 차이면 어쩌지?	0
결혼식에 하객이 없을 까봐 걱정돼	하객 없는 결혼식일까봐 걱정돼	0
나 바보인가봐 사랑한다고 말을 못하겠어	사랑한다고 어떻게 고백하지	0
썸 타는 여자애 프사에 남자 누굴까.	훔쳐보는 것도 눈치 보임.	1
어디서 왔어?	얼마나 노력하면 잘 할 수 있을까?	1
내사랑은 어디 있나	내 짝은 어디있을까	0
시간 잘 떼우는 방법	뭐하면 시간이 잘 갈까	0
오늘도 보고 왔어	오늘도 집에만 있을 예정	1
짝남이 나를 좋아하는 애의 친구인데 어떡해?	짝남이 나를 좋아하는 애의 친구인데 어떡해?	0
직구로 사면 싸겠지	직구로 사야지	0
해외여행 가고 싶어.	해외여행가면 좋겠지	0
아빠가 담배 끊었으면 좋겠어	아빠가 담배 그만 피웠으면	0
맞는 결정을 한거겠지?	나 결정 잘 한거지?	0
소심한 남자와의 연애	연애하는 남자가 좀 소심해	0
이별을 배워가는	이별을 하고야 후회를 하네	1
결혼준비하면서 과연 행복할까 고민돼	결혼해도 되는 건지 모르겠어	0
한 번 사는 인생인데	내 인생의 주인공은 나야	0
좋아하는 여자애 생각하느라 성적이 떨어짐.	좋아하는 여자애 생각하느라 성적이 떨어짐.	0
영양제 좀 먹을까	영양제 뭐가 좋아	0
며칠 전에 다시 만났는데	얼마전 재회했는데	0
운동 좀 잘 하고 싶다. 진짜	운동 잘 하고 싶어	0
많이 약해졌나봐. 내맘이.	말하자면 길어	1
차단 해야할까	힘든 하루	1
이제 막 이별을.	이제 세달째	1
딱 내 취향인데	내 취향인데	0
잘 만나는 중인데 헤어지면 어쩌지 걱정돼	헤어지면 어쩌지 걱정돼	0
취미에 돈이 너무 많이 들어	취미생활하는데 돈이 많이 들어	0
머리 냄새날텐데 	오늘 머리 안 감았는데	0
그녀의 환심을 살 수 있는 방법이 뭐가 있을까?	환심을 살 수 있는 방법은 뭘까?	0
내가 호구냐구	나를 호구로 아는 사람 어떡해?	0
약속을 계속 미루는 썸남	썸이라고 생각했는데 약속을 계속 미루니까 속상하다	0
잘지내고있니	잠 못 이루는 어느날.	1
넌 너무나도 잘지내고있구나	넘 많이 먹었다.	1
정말 힘드네.	정말로 끝났네 이젠	1
마지막이 될 편지.	막장으로 가네	1
장거리 연애 괜찮을까	장거리 연애 괜찮을까	0
완전 귀여워	완전 귀여워	0
누군가를 좋아하는게 과연 행복한 걸까.	누군가를 좋아하는게 과연 행복한 걸까.	0
남자친구가 비혼주의래	남친이 이제와서 나한테 비혼주의래	0
정리가 되네	정말 꿈같다.	1
인턴 합격	인턴 됐어	0
자기 소개서 오글거려	자소설 쓰는 중	0
짝녀 보고싶다.	짝녀 보고싶다.	0
돈이라도 많으면 좋을텐데	돈 많으면 좋겠지?	0
어떻게 하면 호감형이 될까	사람의 마음을 얻는게 어려워	0
이제 끝인가봐	이제 놓아주렵니다	1
썸 타는 사람 있는데 망설여지는데	썸 타는 사람 있는데 망설여지는데	0
마음이 변하는 이유	마음이 어려워서 들어왔어	1
키가 조금만 더 컸으면 좋겠어	키 컸으면	0
꽃다발 선물 어때?	꽃다발 선물 괜찮지?	0
사귀자는 말 아니면 썸인가	사귀자는 건가 아니면 썸인가	0
그냥 보내려 합니다.	그냥 차단이나 하지.	1
9년간의 연애.	SNS 흔적	1
이 정도면 내가 좋아하는 걸 알까?	이 정도면 내가 좋아하는 걸 알지 않을까?	0
회사 체육대회라니	회사 체육대회 가기 싫다	0
다정했던 너는 이미 죽었다.	답답하네. 재회 하고 싶어	1
은근히 따돌림 당하는 기분이 들어	나 왕따인거 같아	0
이별한지 20일째	이별한지 3일째네	1
이야기를 한번 해보려 합니다~	이제 1년 됐습니다	1
참외 맛있다.	참외 먹어야지	0
동호회 나가야 하나	동호회 나가기 귀찮아	0
좋아하는 사람이 있어.	좋아.	0
사랑스러운 눈빛	눈빛 사랑스러워	0
머리 깎아야겠다.	머리 깎아야지	0
말을 못하겠어	주눅들어서 말을 못하겠어	0
짝녀 때문에 화가나요.	짝녀 때문에 화가나요.	0
내 친구에게 내 험담을 하다니	내 지인한테 내 험담했대	0
여자친구가 감정없이 카톡 답장해	여자친구가 감정없이 카톡 답장해	0
나 좀 사랑해줘	사랑한다고 말해 줘	0
뭐라 하려다 참았어	뭐라고 하고 싶었는데 참았어	0
나만 안되는 연애	나이 차이 많이 나는 남자 어때?	1
자꾸 날 칭찬하는 여자애. 나한테 관심있는거 아니야?	나한테 관심있는거 아니야?	0
짝녀한테 주말에 보자고 연락했는데 일정이 있대요. 언제되는지 계속 물어도 될까요.	짝녀한테 주말에 보자고 연락했는데 일정이 있대요. 언제되는지 계속 물어도 될까요.	0
썸녀 꿈 꿨어.	썸녀 꿈 꿨어.	0
술 먹는데 챙겨주는 짝남 무슨 의미일까요.	이별 왜 찾아오는 것일까?	1
좋아하는 사람이 거짓말을 하면 어떡하죠.	좋아하는 사람이 너무 철벽치는데 계속 다가가도 될까?	1
썸인데 영화보재 뭐 보지?	썸인데 영화 뭐 보지?	0
편안하게 보자는 말	포기해야하는걸 알면서도 난 왜이러니.	1
엄마한테 또 화냈어	엄마한테 막말했어	0
집나가도 갈 데가 없어	가출해도 갈 데가 없어	0
만난지 1년인데 결혼해도 될까?	만난지 1년인데 청혼해도 될까?	0
많이슬퍼하고 그리워해야	맘 추스리며.	1
미쳐	미치겠습니다 연락하고 싶어서	0
비싼게 맛있어	입이 고급이야	0
스트레스 푸는 방법	스트레스 받는 데 어떻게 하면 좋을까	0
사랑해서 너무 행복해	사랑해서 요즘 많이 행복하다	0
여자들이 좋아하는 남자들 스타일이 어떻게 됨?	여자들이 좋아하는 남자들 스타일이 어떻게 됨?	0
건조하네	되게 건조하네	0
월세방 비싸	월세 너무 비싸	0
대기업은 접어야 할 듯	대기업 아니어도 될까?	0
맘 편한 데가 없어	마음 둘 곳이 없어	0
면허 없는데	면허 없는데 따야겠지	0
먼저 고백하는 게 좋을까	그냥 먼저 고백하는 게 좋을까	0
고백 받으면 기분 어떨까?	고백 받고 싶어	0
청첩장 고르고 왔는데 맘에 들어	오늘은 청첩장 고르고 왔어	0
600일 좀 넘은 저의 사랑 그리고 이별이야기	6개월만에 다시 만납니다.	1
친구 사이 같이 지내는 연애 하고 싶어	연애하면서도 친구 같으면 좋겠다.	0
무너진 신뢰 쌓아가기	무서운 감정기복	1
연애도 좋지만 내 시간도 중요한 나 정상일까?	연애보다 내 시간이 더 소중해	0
마음이 꽉막힌듯해요	마음이 더이상 커지지 않았으면 좋겠어	1
돈 빌려줬는데 연락 안 받아.	돈 빌려줬는데 전화 꺼져 있네.	0
집 팔거야	집 팔려고	0
가족들이랑 어디 가지?	가족 여행 어디로 가지?	0
일하면서 애키우기 힘들다	워킹맘 진짜 힘들다	0
곱창 생각나	곱창 먹고 싶어.	0
나보다 친구들을 더 좋아하는 남친.	나이들수록 좋아하는게 두려워져요.	1
짜증 수준이 되어버렸습니다	짧은 시간이었다.	1
스테끼 먹은거 몇 년 만이냐	오랜만에 스테끼 먹고 싶어	0
저도 가슴 아픈 이별을 했습니다.	적응이 안되네.	1
내가 너무 쉽게 보였나?	내가 쉬워보이나?	0
헤어진 여자친구와 재회하고 싶어	헤어진 지 2주 파혼	1
그냥 공무원이 좋을 듯	공무원 준비할까	0
내가 좋아하는 걸 티냈는데 못 알아챘을까?	내가 좋아하는 걸 티냈는데 못 알아챘을까?	0
가슴 한편이 꾹꾹하네	가슴이 아프네	0
소화시켜야 하는데 움직이기가 싫어	너무 많이 먹어서 소화시켜야 하는데 움직이기가 싫어	0
자꾸 봐주니까 기어오른다	자꾸 화가나	1
그사람도 이별을 준비 중인 걸까	근데 헤어지고 별로 힘들지 않은건 왜그런건가?	1
다른 사람도 다 힘들겠지?	누구나 힘든거지?	0
사랑이 뭔데 힘들게 하는지	사랑이 뭔데 이렇게 힘들지	0
미치겠습니다 하	미친게 맞는걸까.	0
술이나 마시고 싶다	술 좀 마실까	0
의외야	의외인 점이 많은 사람이야	0
잘 참아오고있는데	잘살아야 되는데	1
중고로 사길 잘 한거 같아	중고로 잘 산 거 같애	0
너무 추우니까 아무 생각도 안나	결혼하고 나니까 너무 맘대로 하는 거 같아	1
나 혼자만의 썸일까?	나도 모르게 니 생각을 하고 있어	1
결혼해서도 설렐까?	계속 살아도 될까?	1
싸우다보니까 사랑했던걸 까먹어	자꾸 싸우다보니까 사랑했던 것도 까먹어	0
남자친구가 여사친들이 너무 많아	남자친구 게임을 너무 많이 해	1
탄생의 이유 알아?	나는 왜 태어났을까	0
당당하기가 어려워	항상 당당하고 싶어	0
다른 사람은 다 행복해보여	나만 빼고 행복해보여	0
마음에 하나도 안 들어	다 마음에 안 들어	0
넘넘 외로워 죽겠어	너무 외로워	0
실수한거 같아	나 실수한건가	0
에어 후라이어 사고 싶다.	튀김기 사고 싶다	0
나를 좋아하는 사람을 만나는 건 축복일거야.	내사람을 만나는 건 축복일거야.	0
나 혼자서 축구 본다	혼자 축구 보는 중	0
썸에서 발전하고 싶어	썸에서 발전하고 싶어	0
좋아하는 감정을 스스로 다스릴 수 있을까?	좋아하는 감정을 스스로 다스릴 수 있을까?	0
이별한지 4개월째.	이별한지 오개월째	1
너 이러면 미워한다	미워	0
썸 타는 사람이 셀카 보내는 건 마음 있는 건가	썸 타는 사람이 셀카 보내는 건 뭐야?	0
나 뒷담화하는 애 어떻게 할까? 	나 뒷담화하는 애 있다는데 어떻게 하지? 	0
삼겹살에는 역시 소주지	삼겹살에 소주 한잔 먹으면 좋겠다.	0
우산 또 사야하나	우산 몇 개째 사는 건지	0
좋아하는 남자 표정이 너무 차가워서 다가가기 어려워.	좋아하는 남자애가 바람둥이 같은데 계속 좋아하면 안되겠죠?	1
방금 너무 울었어	방금도 엉엉 울었네	0
쫄면 생각나	쫄면 먹고 싶다	0
집을 왜 물어보지	집이 어디냐고 왜 물어보지	0
로또 당첨 번호 불러봐	로또 번호 알려줘	0
하우스푸어될듯	하우스 푸어가 될 거 같아	0
이제 일주일	이제 정말 끝이겠죠	1
좋아하는 여자 페북 친구도 아닌데 좋아요 눌렀음. 쪽팔려.	좋아하는 여자 페북 친구도 아닌데 좋아요 눌렀음.	0
친구네 간다.	친구네 놀러가.	0
비밀번호 기억안 나	비밀번호 까먹었다	0
짝사랑 하는 사람보다 좋은 사람 만날거야.	짝사랑 하는 사람보다 좋은 사람 만날거야.	0
진짜 하루하루 너무 마음 찢어지고 숨 못쉬겠어	질질 끄는연애 드디어끝이네.	1
결혼해도 될까?	계속 사랑하고 싶다	1
천재였으면 좋겠다	쪼금만 더 똑똑해지면 좋겠다	0
오랜만이네	오랜만이네	0
남자친구 또 운동 갔어	남자친구가 너무 운동만 해	0
좋아하는 애랑 같이 있으면 나만 이래?	좋아하는 애랑 같이 있으면 나만 이래?	0
판도라의 상자를 연 기분	판도라의 상자를 연 거 같아	0
아침에 일찍 일어나서 뭔가 해야겠어.	아침에 일어나서 뭔가 해보려고	0
헤어지고 나니까 휘청거리네여	헤어지고 뜨문뜨문 연락은 다시 시작하긴 뭐하고 남주긴 아까운 뭐 이런마음인건가?	1
내 아이돌이랑 연애하보고 싶다	내가 무의식 중에 무시하는 듯한 말투를 썼어	1
친구로 남는게 좋을까 그냥 고백할까?	친구로 남는게 좋을까 그냥 고백할까?	0
결국 파혼했어!	결국 헤어졌네.	1
좋아하는 오빠가 날 어리게만 봐.	좋아하는 오빠가 날 어리게만 봐.	0
좋아하는 사람이 자꾸 나한테 전여친 얘기해.	좋아하는 사람이 자꾸 나한테 전여친 얘기해.	0
짝남이 운동선수인데 연락하면 귀찮아할까?	짝남이 운동선수인데 연락하면 귀찮아할까?	0
몇 년을 좋아했는데도 관계가 달라진게 없어.	몇 년을 좋아했는데도 달라진게 없어.	0
키 큰 여자는 별로인가?	키 큰 여자는 별로인가?	0
열심히 공부해야지	이번 학기 열심히 살아야지	0
좋아하는 애가 좀 노는 애인데 좋아해도 돼?	좋아하는 애가 좀 노는 애인데 좋아해도 돼?	0
안경 쓰는 여자애 좋아하는 남자 있어?	혼자만 설레고 혼자서 끝내는 짝사랑 그만할래.	1
결혼할 때 되니까 너무 바빠	이 결혼 잘 한 걸까	1
여자친구한테 더 이상 설레지 않아	여자친구한테 더 이상 설레지 않아	0
수영하러 다닐까?	수영 배울까?	0
개념이 없어	개념도 놓고 옴	0
남편이 왜 애키우는거 안 도와줄까	남편이 육아에 무신경해	0
이자 왜 이렇게 많지?	대출 이자 왜 이렇게 많이 나오지?	0
자존감 좀 높이고 싶다.	자존감 어떻게 올려?	0
지금 가장 힘든 거는	지금도 전하지 못하는 한 마디	1
배려 있는 사람이 좋은데	배려 잘 하는 사람이 좋은데	0
벌써 방학 끝이라니	벌써 개강이라니	0
또 뭘 먹나	오늘은 또 뭘 먹나	0
사랑 존재하기는 해?	사랑이란게 있기는 해?	1
남사친인데 요즘 관심 가.	남사친이었는데 요즘 조금씩 좋아져.	0
맨날 똑같아	별다른 게 없어	0
헤어진지 한달하고 이주 정도 되었네	헤어진지2주가지났네	1
울 남친은 애교가 많아	남자친구가 애교가 많아	0
위험한 사랑 해도 될까?	위험한 사랑 해도 될까?	0
남자는 호감 없으면 연락 안해?	남자들이 싫어하는 여자들 특징은 뭘까요.	1
불토 달리고 싶다	붙잡으려 말 것!	1
죽어가는.	준비중	1
카톡프사 바뀌었어	카톡으로 사진을 보내왔어	1
그는 내 마음을 알까?	내 마음을 알까?	0
짝사랑 끝내고 나니 마음이 공허하다.	짝사랑 끝내고 나니 마음이 공허하다.	0
피피엘 너무 심하네	PPL 심하네	0
밥 먹었는데 배고파	밥 먹었는데도 또 배고파	0
생각할수록 머리 아파	머리 아파	0
어디서 맛난 냄새가 나는데	맛있는 냄새나	0
썸남이 다른 사람 감정에 좀 둔한듯	썸남이 곰돌이 같아. 좀 많이 둔한 듯	0
후 아직 헤어진것도 아닌데	후밤에 집에 혼자있으려니 답답하네	1
여자 친구랑 연락이 안돼	여자친구랑 전화 안 받네.	0
자취한다는데 뭘 챙겨줄까?	자취한다는데 뭘 챙겨줄까?	0
참 무섭네 사람 마음이란게	참 잘낫네	1
회사 사람들이 아직도 불편해	엄마아빠랑 다시 같이 살아야돼	1
친구한테 몇 년만에 연락해도 되나	연락 안 하던 친구한테 연락해도 되나	0
헬스장에서 인사하는 사람 맘에 드는데 번호 달라고 할까?	헬스장에서 인사하는 사람 맘에 드는데 번호 달라고 할까?	0
사랑 때문에 죽고 싶어	그 사람이 좋아서 죽고 싶어	0
청첩장 돌리기 귀찮아	청첩장 돌리기 귀찮아	0
씻고 자야 되는데	씻고 자야지	0
오늘 큰맘 먹고 연락했습니다	오늘 큰맘 먹고 연락했습니다	0
왜 나를 의심하지	증거도 없으면서 나만 의심해	0
짝남이 잘생긴건 아닌데 착해.	짝남이 잘생긴건 아닌데 착해.	0
커피 맛있어	불 날 뻔	1
수수한 여자가 좋아	이별 너무 힘드네ㅠ	1
여름을 시원하게 보내는 방법	이번 여름 너무나 더워	1
이제 놓아 주려고	이제 마음을 정리할 때가 된거같아	0
짝녀는 짝녀일 뿐이건가.	짝녀는 짝녀일 뿐이건가.	0
짝남한테 시덥지 않은 걸로 선톡해도 될까?	짝남한테 시덥지 않은 걸로 선톡해도 될까?	0
꽃선물 받고 어	꽃 받고 싶다	0
변화를 좀 주고 싶다.	나 바뀌고 싶어	0
살찐 거 같아	또 살찐 거 같아	0
개인적인 일도 다 시켜	개인적인 업무까지 다 시켜	0
회사가는 길에 매일 보는 사람 있어	출근 길에 맨날 보는 사람 있어	0
알뜰폰 괜찮을까	알뜰폰 어때?	0
내가 좋아하는 거 티내면 싫어할까?	내가 좋아하는 거 티내면 싫어할까?	0
단둘이는 처음 만나는 날ㅋㅋ	단둘이는 처음	0
그녀는 내게 돌아오지 않아 이젠 잊어야해.	그녀를 떠나 보냈습니다.	1
내 마음 알면서도 모른척하는거면 어떡해?	내가 너무 이기적이었어	1
대학 나온 거 부러워	좋은 대학 나온 거 부러워	1
학원에 좋아하는 남자애가 생겼어요.	학원에 좋아하는 남자애가 생겼어요.	0
위로가 필요해	너 위로 잘 하니	1
사표 낼까?	일 때려칠까?	0
나 어장인듯	어장 관리하는 것같아	0
완벽하게 좀 하고 싶다.	완벽해지는 방법	0
마지막 말	마지막 사랑	1
상속주택의 나라사랑대부를 계속 유지할 수 있는지요? 	성경구절중에 사랑한다는 표현하는 구절좀 	1
최고다 행복해	인생에서 최고의 행복	0
길에서 담배 피우는 사람 싫어	간접흡연 싫어	0
실험실 더러워	실험실이 너무 더러워	0
회사 사람들이 아직도 불편해	후.ㅎㅎ	1
대리효도 짜증	대리효도 극혐	0
술 한잔만 마셔도 어지러워	술을 너무 못 마셔	0
썸 타는데 사랑하다고 말할 수 있음?	썸녀한테 사랑하다고 말할 수 있음?	0
아이공 허리 아파라	허리 아파	0
입 안이 텁텁해	입이 텁텁하다	0
수학여행가는데 옷 뭐입을까	수학여행가는데 입을 게 없어	0
장거리하다가 결혼 가능할까?	장거리하다가 결혼 가능할까?	0
도시락 싸왔어	도시락 싸옴	0
화장 안했는데 썸남이 영통 걸었어.	화장 안했는데 썸남이 영상통화 걸었어.	0
결혼하자고 말할까?	같이 살까?	0
놀아줄 친구가 없어	친구 없어	0
십년감수했어	나 죽을 뻔함	0
어린이집 입학식 가야겠지	어린이집 입학식 꼭 참석해야하나?	0
그녀가 정말 떠납니다	그녀로부터 연락이왔습니다	1
썸남 목소리 듣고 싶어.	썸남 보고 싶어.	0
벌써 생활비가 없어	생활비 다 썼네	0
자꾸 꿈에 나와여ㅠ ㅠ	자꾸 심하게 차였는데.생각나네	1
하울이나 할까	쇼핑이나 할까	0
짝녀한테 공부 가르쳐달라고 해볼까	짝녀한테 공부 가르쳐달라고 해볼까	0
이별 5달	이별 괜찮타.	1
저는 4시간에 걸쳐서 정리를 했습니다	저도 어쩔 수 없는 찌질한 남자인가 봅니다.	1
바람이나 비슷한 일 용서해주신 사람 있을까 ?	바빠졌으면 좋겠어	1
졸업식이야	와우 드디어 졸업한다	0
괜찮을줄 알았는데	구걸하듯 사랑하지 마	1
나약한 생각	나의 자만심 때문에	1
썸탈때 스킨십 해도 돼?	썸탈때 스킨십 해도 돼?	0
이별 후 한달	이별. 몸이 버티질 못하네.	1
가족한테 스트레스 풀었어	스트레스를 가족한테 풀어	0
좋아하는 사람 이상형에 나를 맞춰야 할까?	좋아하는 사람 이상형에 나를 맞춰야 할까?	0
결국 연락을 해버렸네.	결국 이렇게 될 꺼면서.	1
보이스피싱 전화왔어	보이스피싱 당했어	0
헤어진 여친에게 문자 보내려고.	헤어진 지 한달됐습니다	1
더 이상 사랑 때문에 상처받기 싫어	도대체 왜 이러는걸까	1
정수리 냄새	정수리 냄새 난 거 아니야?	0
발렌타인데이 선물 비싸	발렌타인데이 초콜릿 비싸	0
먹을 거 뭐 없나	뭐 먹을 거 없나	0
끝까지 함께 할 거라 믿었는데	끝이 보이지 않는 터널 같습니다.	1
맛있는 거 먹는데 생각나는 사람	맛있는 거 먹을 때 생각나는 사람	0
다시 사랑이 오겠지?	더 알고 싶어 지는 사람이야	1
짝녀가 절 신경쓰는 것 같은 건 내 착가인가요?	짝녀가 절 신경쓰는 것 같은 건 내 착가인가요?	0
오늘 왠지 고백 받을 것 같음.	오늘 왠지 고백 받을 것 같음.	0
상처입은 사람한테 다가가기	상처 있는 사람에게 다가가기	0
오늘도 과거속에 머물며 제자리걸음이네	오늘도 연락하고싶은거 꾹.꾹 정말 참았습니다.	1
썸 타는 사람이 꿈에 나왔어.	썸 타는 사람이 나오는 꿈 꿨어.	0
유부남됐어!	유부남됐어!	0
그냥 다 포기하려구	그냥 보고싶다	1
두 여자 사이에서 갈등하고 있어	두 여자 사이에서 갈등하고 있어	0
썸도 문화차이가 있나	흑기사 해주는 짝남.	1
소나기 내려	비 온다	0
내가 좋아하는 걸 티냈는데 그 사람은 반응이 없어.	내가 좋아하는 걸 티냈는데 반응이 없어.	0
이제 겨우 일주일 됐네	이제 나 자신으로 돌아와 아름다워지고 싶어.	1
잊혀지면 얼마나 좋을가.	자기관리가 답인듯.	1
기침도 못하겠어	기침도 편하게 못해	0
신혼 길게 즐기고 싶어	신혼 생활 길게 즐기고 싶어	0
내일 하루 종일 바빠	낼 바쁘넹	0
여자친구가 너무 이쁘고 내가 못 생겨서 너무 자존감이 떨어짐	여자친구가 너무 이쁘고 내가 못 생겨서 너무 자존감이 떨어짐	0
입장이 바뀐 상태에서 오랜만에 와보내	잊기가 너무 힘드네	1
썸남 아직은 좀 부담 돼.	썸남 가끔 부담 돼.	0
점점 나아진다.	조금씩 잊고 있어	0
아무 것도 할 수 없는	아무리 기다려도 이젠 안돌아오나봐	1
사과해야 하나?	사람과의 이별은 아니구	1
회사랑 집 가까우면 좋겠다	회사 옆에 집이 었으면	0
시누 좀 이상한 듯	시누이가 이상해	0
엄마가 안 왔으면 좋겠어	학부모 총회에 엄마가 안 왔으면 좋겠어	0
라면 먹고 잤더니 부었어	라면이랑 김밥 먹고 싶다.	1
너무 두려워.	너무 보고싶네.	1
다시 힘들어지네 ㅠㅠ	다 잊은것 같다가도 생각나	1
내가 너무 방심했어	방심하는게 아니었어	0
뉴게임 없나?	새로운 게임 없나?	0
그녀를 닮은 여잘 보고	그녀를만나고와서	1
영화가 재미 없어	영화봤는데 재미 없어	0
연애 감흥이 점점 사라져	점점 연애 감정이 사라져	0
와 미친거 같네	완전히 끝났네	1
사진을 보다가	살만 찌네	1
진짜 무력하다	내가 무능력하게 느껴져	0
팀플 안 하면 좋겠다	팀플 좀 안 했으면 좋겠다	0
썸 타는 중에 데이트 비용은 누가?	힘들어서 결혼할까봐	1
한번쯤 진하게 아픈것도 괜찬아.	한숨	1
좋아하는 연예인 바뀔 때마다 짝남이 바뀌는 듯.	좋아하는 연예인 바뀔 때마다 짝남이 바뀌는 듯.	0
스터디 하다 만났어	스터디 하다 만났어	0
짝남 표정 안좋아서 괜히 신경 쓰여.	짝남 표정 안좋아서 괜히 신경 쓰여.	0
절친이 오늘 모른척했어	절친인데 쌩깠어	0
칭찬 좀 해줬으면	칭찬 좀 해줬으면	0
통장 잔고가 하나도 안 남았어.	통장잔고가 0이야	0
나들이를 가볼까	바람 쐬러 나갈까	0
짝녀가 고시생인데 언제까지 기다려야 할까요.	짝녀가 고시생인데 언제까지 기다려야 할까요.	0
썸타다가 갑자기 연락이 없어	썸타다가 갑자기 연락이 없어	0
헤어졌다가 다시 연애하는데 잘 사귈 수 있을까?	헤어졌다가 다시 연애하는데 잘 사귈 수 있을까?	0
오늘 헤어졌어.	오늘도 버티고 버팁니다	1
그녀의 결혼 너무 가슴이 아프네	그녀의 소식 친구로부터 전해듣기.	1
다른 사람을 설득하는 거 힘들다.	다시 한 번 설득해 볼까	1
외롭지만 혼자 걸을수 있어_조성모	욕까지 먹었는데 정이 안 떨어져	1
전 너무 이기적인데 저를 좋아해줘요.	이기적인거 알지만 그래도 좋아해줘요.	0
여우같은 애한테 당했어	여우한테 당했어	0
다 잘맞는데 가치관이 다른 연애가 고민.	댄디한 남자 사귀고파	1
더워서 잠을 못자	요즘 잠을 못자	0
울면서 카톡 보냈어 너무 힘들어서	원래 여자들은 냉정하나	1
미끄러질 뻔했어	나 넘어질 뻔했어	0
걸레질도 해야 돼	물걸레질해야지	0
핸드폰이 잘 안돼	핸드폰이 맛 간거 같아	0
언제 사랑 받는구나 느껴?	언제 사랑 받는구나하고 느껴?	0
좋아하는 여자가 톡을 씹어.	좋아하는 여자가 톡을 씹어.	0
내가 좋아하는 사람이 나를 창피해하는 것 같아.	내가 좋아하는 사람이 나를 창피해하는 것 같아.	0
예의 차리래 지는?	나한테만 예의 차리래	0
카리스마 있는 사람이 좋아	카리스마 있는 사람이 좋아	0
구속을 너무 많이 해	구여친이랑 헤어진지 꽤 됐는데 좋아하는 사람이 없음.	1
알바 집 알바 집 이게 뭐냐	알바만 하고 살고 있어	0
서핑하러 가고 싶다	서핑하러 가고 싶다	0
짝남한테 늦은 생일 선물 주러 가는데 떨려.	짝남한테 늦은 생일 선물 주러 가는데 떨려.	0
교양수업 시간에 마음에 드는 애 있어	교양수업에서 마음에 드는 애 있어	0
오늘처럼 사랑하기	오늘처럼 사랑하기	0
깨끗하게 보내야 하는데	꿈 때문에 새벽에 깨게 되네.	1
결혼하면 안 좋은 점?	결혼하면 나쁜 점	0
남자들 진심으로 좋아하는데도 이렇게 행동할 수 있나요?	남자랑 단둘이 술마시는 여자친구를 이해해줘야할까?	1
소개팅하고 애프터까지 왔는데 설렘이 없어.	소개팅 애프터까지 왔는데 안 설레.	0
이 세상에서 누가 제일 예뻐	이 세상에서 제일 예쁜 사람은	0
조용한 여자가 좋아	조용한 여자가 좋아	0
살면서 남편이 더 좋아져	살면서 남편이 더 좋아져	0
나도 사랑 받고 싶아.	나 좋아해줬으면 좋겠다	0
자꾸 짝남 얼굴 생각나.	짝남 얼굴 생각나.	0
차 렌트 해서 가야겠다.	렌터카 빌려서 돌아 다녀야겠다.	0
짝남한테 고백한다? 안한다?	짝남한테 고백한다? 안한다?	0
남자친구가 데이트 통장을 제안하는데 어떻게 생각해?	남자친구가 데이트 통장을 제안하는데 어떻게 생각해?	0
그림 좀 잘 그렸으면 좋겠다	그림 잘 그리고 싶다	0
소개팅 하고싶다	소개팅도 안 들어와	0
좋아하는 오빠가 최근에 연락이 계속 늦거나 이어지지 않는데 그냥 연락 끊어야 할까.	좋아하는 오빠가 최근에 연락이 계속 늦거나 이어지지 않는데 그냥 연락 끊어야 할까.	0
불편한 사이가 된 거 같아	갑자기 불편한 사이가 된 거 같아	0
휴학하는 게 나을까?	휴학해야하나?	0
고뱄했는데 너무 떨려.	공휴일에 데이트하자고 해봐야지	1
뭐 한두번도 아니지만	뭘해도	1
우리반 여자애가 나 좋아하는 거 너무 티냄.	우리반 여자애가 나 좋아하는 거 너무 티냄.	0
여자친구가 돈을 안 써	여자친구가 돈을 안 써	0
주름살 생겼어	나이먹으니까 주름살 생겨	0
메모리카드 어디다 두었을까	메모리카드 잃어버렸어	0
진급할 때가 된 거 같은데	왜 진급이 안 되지	0
오래 만났어	이제 짝남 보내기로 했어요.	1
멋지게 나이들고 싶다	멋지게 늙고 싶다	0
시급 얼마 받니	최저시급은 받니	0
그 사람 생각에 잠이 안 와.	그 여자를 좋아해도 되는지 고민이 됩니다.	1
누군가 제 이야기를 들어줬으면 해서 올리내.	눈물이 많터냐	1
나는 꼼꼼한데 여친은 안 꼼꼼해.	나도 좋아하는 사람이랑 놀러가고 싶어.	1
주택 청약 가입	주택 청약 시작!	0
이제 정말 놓으려구.	이제 탈퇴합니다	1
썸 타는 사람한테 영화 보자고 할까?	썸 타는 것 같은데 영화 보자고 할까?	0
좋아하는 감정을 억제하는 방법은 뭐지.	좋아하는 감정을 억제하는 방법은 뭐지.	0
드디어 그 순간이 거의 다가왔습니다.	드디어 제가 손을 놓았어.	1
짝녀한테도 철벽쳐요. 성격이 왜 그럴까요.	짝녀한테도 철벽쳐요. 성격이 왜 그럴까요.	0
우와 우와 대박이네	소확행으로 힐링	1
이별하고 목숨까지 끊는 사람들 전혀 이해 못 했는데	이별하려다 붙잡고 다시 사귀는데	1
내가 힘든 게 많다	세상엔 힘든 게 많다	0
만나는게 힘들어지네	만나고 헤어지고 다시 만났어	1
살아야 하는 이유	살아서 좋은점	0
난 안돼 난 못 받아들여 제발	날 보는걸 벌레 보듯하던 니 시선	1
남자친구 자취 선물로 뭐가 좋을까?	남자친구 자취방 선물 뭐가 좋을까?	0
이별 이후.	이별 참 힘드네	1
참 많이 사랑했는데.	참 많이 좋아했는데.	0
부모님이 내 꿈을 반대해	부모님이 내 꿈을 무시해	0
남자친구가 작은 일을 다 잊어버려	남자친구가 소소한 일은 자꾸 잊어버려	0
핸드폰 떨어뜨려서 고장 났나봐	행복해져야해	1
쿠폰 다 모았다.	쿠폰 다 모음	0
그사람이 자꾸 꿈에 나와	글을 쓰게 되네	1
내가 좋아하는 남자를 만나는게 나아? 나를 좋아하는 남자를 만나는게 나아?	내가 좋아하는 남자를 만나는게 나아? 나를 좋아하는 남자를 만나는게 나아?	0
아 오늘 힘드네	아. 힘든 날이네	0
장거리 썸 괜찮을까	장거리 썸 고백해도될까	0
나쁜 사람인 걸 아는데도 좋아하는 마음이 사라지지 않아.	나이트갔는데 이상형 만났어	1
너덜너덜해진 느낌이야	헌신하다 헌신짝 될 거 같아	0
인생 공부한건가	인생의 쓴맛	0
애매모호한 썸 그냥 끝낼까?	애매모호한 썸 그냥 끝낼까?	0
살 때문에 교복이 잘 안들어가	살 쪄서 교복이 껴	0
내가 진짜 미친다.	헤어진지 한달 지났네	1
혼자 좋아하는 이야기.	혼자 좋아하는 이야기 들어볼래요?	0
그냥 내버려 둬 주었으면	나 좀 내버려 뒀으면	0
헤어지자는 남친 잡아도 될지모르겠어	헤어진 날 부터 오늘까지	1
막말 들으니까 좀 힘빠지더군	오늘 더워서 힘이 안나	1
흔적	희생하는 것이 내 방식인 연애. 5년간 사귀다 이별했습니다	1
이건 뭘까?	이게 사람 얼굴인지.	1
저녁하기 귀찮다	짜장면 시킬까	1
여행 가야지	여행 계획 세워야지	0
커피 마시고 싶어	커피 땡기네	0
그 사람이 영화보재	영화 뭐 보지?	1
인형 뽑기 해줘	인형 뽑아줘	0
우리 언니 남친이 날 좋아하는데 방법 좀.	우리 언니 남친이 날 좋아하는데 방법 좀.	0
짝남 관련 악몽을 꿔.	짝남 관련 악몽을 꿔.	0
짝녀가 외국인인데 좋아해도 되나?	짝녀가 외국인인데 좋아해도 되나?	0
짝녀가 외국인인데 연락처 물어봐도 될까.	짝녀가 외국인인데 연락처 물어봐도 될까.	0
만난지 세달만에 결혼 가능함?	만난지 세달만에 결혼하자고 해도 될까?	0
머리 기름낀거 티나나?	머리 안 감은 거 티나나?	0
다 잊었는데 다시 그녀가 나타났어	대화가 잘 통하는 사람이야	1
연락 안하고 가만히 있는게 맞는 걸까?	연락을 기다려야 해? 아니면 찾아가야해?	1
보증금 모잘라	보증금 마련하는 게 쉽지 않네	0
참담하다	처음글남기네여	1
뿌리 염색 다시 해야 되겠다	뿌염해야지	0
불만족스러워	내가 만족을 못해	0
심술나	갑자기 나쁜 생각이 막 들더라	0
좋아하는 사람에게 요리를 해주면 좋아할까?	좋아하는 사람의 호감을 살 수 있는 방법이 뭐가 있을까.	1
준비할 시간을안주네	지금 무작정 보러가는중입니다	1
이제 그만	이제 나름의 정리를 시작해보려구.	1
복전하고 싶어	복수전공하고 싶어	0
시간 진짜 빨리감	시간 왤케 빨리감	0
9년이 넘는 연애를 끝냅니다	가벼워졌다고 생각했는데	1
헤어져야 할 거 아는데 괴로워	헤어졌는데 아픔보다는 미움.원망	1
괜히 화가 나서 짝남한테 연락 끊자고 했어.	딴일로 화났는데 짝남이랑도 싸움	0
동생이 먼저 결혼한데	동생 먼저 결혼시켜야 하나	0
내 사랑이 있을까?	내가 동성을 좋아하는 것 같아.	1
내일 발표 나는데 떨려	내일 발표인데 떨려	0
요리 재밌어	요리하는게 재밌어	0
스트레스 다시는 받지 않는 법	그냥 잊어버리려고 해	1
혼수 준비하는데 돈 많이 들겠지	혼수 비싸겠지	0
대출 언제 다 갚냐	대출이 너무 많아	0
기분 꿀꿀해	오늘 괜히 기분 꿀꿀해	0
3년 반의 만남 끝에 헤어지게 되었습니다.	3년 째 트라우마	1
오늘 까먹고 아무 것도 안 가져 왔다	오늘 아무 것도 안 가져 왔다	0
동거 하다 걸렸어	아놔 동거하다 걸렸어	0
인기 많으려면	친구들한테 인기 얻으려면	0
썸 타는 방법 좀 알려 줘	썸 타는 법 좀	0
그 사람 때문에 하루에도 몇 번씩 기분이 오르락 내리락 해.	그 애도 내 생각을 할까?	1
쌤이 나만 뭐라 해	선생님이 나만 뭐라고 해	0
이제 한 삼주 되었나?	이제는 너를 보낼 시간이 가까이 오는구나.	1
군대를 기다리는게 너무 힘들어	그 남자를 좋아해도 되는지 고민이야.	1
모른척 해줬어	모른척 지나쳤어	0
사내에 좋아하는 여자분이 생겼는데 조심해야겠지.	회사에 좋아하는 여자가 생겼는데 걱정되네.	0
신뢰 회복할 수 있을까?	신뢰에 금 간 거 같은데 회복할 수 있을까?	0
3개월이라는 시간이 흘렀지만 여전히 제자리걸음	3년 동거 돈 싸움. 헤어짐	1
짝사랑 하는 여자애가 오늘 꿈에 나온다면 소원이 없겠네.	짝사랑 하는 여자애가 오늘 꿈에 나온다면 소원이 없겠네.	0
등록금 너무 비싸다. 허리 휨	등록금 비싸다	0
남자친구 폰 봐도 되나	남자친구 핸드폰 몰래 봐도 되나	0
이제 보내주려 합니다.	이제 여친이 마음이 괜잖아진거같아!!!	1
누구세요?	너 누구냐	0
태어나 단한번도 들어보지못한 이별이야기 도와주세	퇴근길에.	1
재밌는 거 뭐 없나	재밌는 일이 없어	0
돈 없으면 결혼도 못하겠다.	결혼하는데 돈 많이 드네	0
재미있는 드라마 끝났어	드라마 볼 게 없어	0
미팅에서 번호 딴 애가 좋은데 뭐라고 연락을 할까?	미팅에서 만난애한테 뭐라고 연락을 할까?	0
여친이 너무 많이 먹어	나 요즘 밥 너무 많이 먹어	1
남사친이라 쓰고 짝남이라 읽는다.	친구 처럼 하는데 사실 좋아해	0
어떻게 하면 나를 좋아하게 만들지	나 좋아하게 만들고 싶다	0
뜻밖에 연락	마냥 헌신하던 제 모습이 처량하고 화가나네	1
뭘 챙겨주면 좋을까	뭘 챙겨주면 좋아할까	0
사랑할수록 행복해	사랑해서 행복해	0
행운을 빌어줘	나한테 행운 좀 왔으면 좋겠어	0
내가 사랑할 자격이 있나	내가 좋아할 자격이 있나	0
딱 1년 연애	딱 1년 연애했네	0
상 좀 받아야 할텐데	나도 상 받고 싶다	0
좋아하는 여자애가 날 좋아하게 만들고 싶은데 조언 좀.	좋아하는 여자애가 날 좋아하게 만들고 싶은데 조언 좀.	0
이제 3개월이네	이제 끝이네	1
짝녀한테 휘둘리고 싶지 않은데 이러는 내가 싫다.	짝녀한테 휘둘리고 싶지 않은데 이러는 내가 싫다.	0
썸녀한테 미련 남아	후회없이 사랑하고 싶어	1
이번엔 또 뭐 해 먹지	뭐해먹지	0
숨어서 찾기 어려운 맛집 찾아서 먹으러 가는 중	맛집 찾아 다니는 취미 생겼어	0
여자친구가 계획적이지 않아서 스트레스 받아.	여자친구가 계획적이지 않아서 스트레스 받아.	0
하아.	한 번은 더 볼 일이 있을 것 같았는데.	1
공황증	과연 사랑이였을까?	1
어떤 사람이 춥다고 나만 옷 벗어줌.	어떤 사람이 춥다고 나만 웃옷 벗어줌.	0
그녀의 카톡	그대가 보고파	1
안경 벗으면 나으려나	안경 안 어울리는 거 같아	0
사랑한다는 걸 느끼는순간	사랑한다고 순간순간 느껴	0
그만 울어야지	그사람은지금대전에있습니다	1
남자가 더 사랑해서 결혼하면 잘 사나요?	남자가 더 사랑해서 결혼하면 잘 사는게 맞나요?	0
마지막 데이트 하고있는데 이 사람이 미워	마지막 문자를 보내버렸어	1
명절 선물 뭐가 좋을지 알려줘	명절 선물 뭐하지	0
꿀잼	재밌다.	0
일인자가 되려면 얼마나 노력해야할까?	일인자가 되려면 피나는 노력이 필요하겠지?	0
잘 살 수 있겠죠	잘 지내니?	1
걱정 좀 없이 살고 싶다.	걱정 없이 살고파	0
첫사랑을 다시 만났어.	첫사랑을 다시 만났어.	0
발목 접질렀어	발목 삐끗했어	0
사랑 글로 배워요	그래 나는 사랑을 글로 배웠어.	0
직장 동료들이랑 술 마셨어	남자친구랑 술 마셨어	1
과일이랑 채소 챙겨 먹어야지	과일 주스 먹어야겠다.	1
나만 좋아하는 건가 자괴감 들어.	나이 차이 많이 나는 짝녀에게 고백해도될까?	1
왜 내가 해야 하지?	내가 왜 해야하는지 모르겠어	0
우리의 사랑은 끝났어	우리의 사랑은 끝났어	0
환승당했다는 여자입니다.	환승하는 년놈들	1
3달이 지났네	45일만에 진짜 헤어지네	1
후련하달까	또 전화 안받아	1
지는 게 진짜 싫어	지기 너무 싫어	0
컴터가 맛이 갔어	내 이름이 없어	1
나도 성공한 사람들 처럼 되고 싶다.	성공하고 싶다	0
썸이 딱 좋은 것 같아. 연애 싫음.	썸이 딱 좋은 것 같아. 연애 싫음.	0
사귀자고 하고 연락 없어	보고 싶은데 문자 못하겠어	1
소개팅 앱에서 만난 사람 좋아하게 되었는데 괜찮은 사람일까요.	소개팅 앱에서 만난 사람 좋아해도 괜찮을까요.	0
자꾸 함부로 대해	나를 너무 함부로 대해	0
비오면 마중 나와 주는 사람 있어서 좋다	우산을 들고 기다려 준데	0
짝사랑 하는 사람이 너무 잘나서 내가 작아보여.	짝사랑 하는 사람이 너무 잘나서 내가 작아보여.	0
썸남 빼빼로 줘야 함?	썸남 빼빼로 주면 어떨까?	0
게임 재미있어.	게임하고 싶어	0
남자친구가 이벤트 해 주면 좋겠다.	남자친구가 이벤트를 잘 안해줘	0
결정적인 물증이 없어	심증은 있는데 물증이 없네	0
압축적으로 잘 놀고 온 거 같아	우리 정말 잘 노는 것 같아	1
과식했다	너무 많이 먹었어	0
소개팅 어색할까봐 안해봤는데	소개팅 안해봤는데	0
용돈 인상해 달라고 말할까	용돈 올려줬으면	0
화를 못 참겠어	순간의 화를 못 참겠어	0
요즘 드라마 너무 재밌네	요즘 드라마가 땡겨	0
고무신 거꾸로 신으면 어쩌지	군대 기다리면 부담스러워할까	1
한강 밤에 가면 좋겠지?	한강 야경 좋지?	0
장난으로 좋아한 거 아닌데	장난으로 좋아한 거 아닌데	0
적응을 못하겠어	새로운 곳에 적응을 못해	0
이번 달에 결혼식 매 주 있어.	이번 달에 결혼식 너무 많아	0
이제 혼자서도 잘할 수 있어.	혼자서도 잘해요	0
새벽에 울다지쳐 신천에나와 지금까지있네	새해부터는 당신 생각 안하려 했는데	1
딱 좋아	떠나간사람은 이렇게도 차갑나?	1
답례품 뭘로 할까?	답례품 뭐하지?	0
3년이란 시간이 흘렀는대도	3달이지났는데 이제야 헤어짐을 확신했네	1
썸남이랑 꽁냥거리는데 설레.	썸남이랑 꽁냥거리는데 설레.	0
주저리주저리	죽고싶네	1
오늘 백일 기념일이야	오늘 만난 지 백일됐어 시간 짱 빠르다. 	0
이 세상에 나 혼자 남겨진 기분.	나 혼자 남겨진 기분.	0
가슴이 허락하질 않네.	간단하게 사랑이라는건.	1
사랑의 정의	사랑을 한 마디로 정의하면?	0
월요일도 아닌데 차가 너무 많아.	월요일도 아닌데 길이 너무 막혀	0
망했으면 망했으면	이제 그만 망했으면	0
연예인도 힘든게 있겠지?	연예인 되면 피곤하겠지?	0
씁쓸	아 오늘 하루는 어떻게 잊어볼까	1
휴우.	흔적이란게 남은걸까	1
먹방 봤는데 나도 먹고 시프당	먹어도 살 안찌면 좋을텐데	1
남사친이랑 잘 맞아서 카톡이 끊어지지 않는데 이거 그린라이트일까?	카톡 계속하는데 이거 그린라이트일까?	0
발표가 안나	중요한 발표 기다리고 있어	0
헤어지고 이제 알았어	헤어지고나서 다시 붙잡길래 믿었어.	1
전 헤어지고 곧장 소개팅을 했죠.	전남친소식을들었어	1
평가 좀 해줘	제대로 평가해줘	0
썸남 만나기로 했는데 뭐 입어?	썸남 만나기로 했어	1
모든게 다 끝났습니다	몰랐던 때로 돌리고싶어	1
나 왜 좋아할까?	나 왜 좋아해?	0
연애다운 연애 하고 싶어	연애다운 연애 하고 싶어	0
여자친구 마중 나가야지	여자친구 마중 나가야지	0
만나기만 하면 자꾸 싸우게돼	만나기만 하면 싸워	0
날씨가 진짜 덥다	너무 더워	0
나만 힘든거 같아	나쁜 꿈을 꿨어	1
좋아하는 사람이 부담스러워할까봐 친구들 여럿이서 보는데.	좋아하는 사람이 외국인인데 날 부담스러워하진 않을까?	1
재밌없어	재밌는게 없어	0
남편이 하나도 안 도와줘	남편이 나 안 도와줘	0
문득문득 생각나네	뭐 깨진지 몇달도 더 되었지만	1
성형 상담 받아 볼까	성형 견적 받아볼까	0
고기 구워 먹고 싶다.	고기 먹고 싶어	0
삼겹살 구워야지	삼겹살 구워 먹어야지	0
배 터지겠다.	배불러	0
짝녀랑 술 마셨는데 이제 진짜 접어야하나봐.	짝녀랑 술 마셨는데 이제 진짜 접어야하나봐.	0
혼술중	혼자 이겨내기 힘들어	1
이제 숨 좀 쉬나	이제 인정해야할 것 같아.	1
30살이 넘었는데 짝사랑 계속해도 될까요.	3년 사겼는데 이제 결혼해야겠지?	1
헤어지자고 통보 받고 하루만에 다시 재회	헤어지지 않았다면 오늘이 1년째 되는 날이네	1
짝사랑을 하다보니 자존감이 낮아졌어.	짝사랑중인데 그 애는 저를 잘 알지 못하는데 연락을 하면 놀랠까요?	1
혼자 사는 거도 괜찮을 것 같아	혼자 사는 거도 나쁘지 않은 듯	0
적금 하나 더 가입할까	적금 더 들까	0
배우자라고 하니까 이상해	배우자라니 어색해	0
좋은 사람들은 다 어디 갔을까	사회에서도 좋은 사람 만날 수 있어?	0
전기장판 깔고 자고 있어	전기장판으로 겨울 나기	0
수능시험에서 좋은 점수 받는 방법	수능 잘 보는 방법	0
헤어지고 한달 이제야 느낌온다 ㅋ	헤어지기 전 통화	1
사랑하는 사람 잊어야 할 거 같아	사랑하는 사람 잊어야 할 거 같아	0
날씨가 너무 눅눅해	비가 와서 눅눅해	0
다른 사람에게 뺏긴거 같네.	다시 또 가라 앉고 있습니다.	1
수강신청 폭망	수강신청 망했어	0
헤어졌는데 보고 싶어	헤어졌지만 생각나	0
아름답게 잊혀지길	아름답게 잊혀지길	0
마음을 표현하고 싶은데 어떻게 해야 할까요	내 마음 어떻게 말해	0
짝남 정리 잘하고 있었는데 자꾸 꿈에 나와.	짝남 정리 잘하고 있었는데 자꾸 꿈에 나와.	0
입이 헐었어	입 안이 다 헐었어	0
조카들 너무 귀찮게 해	조카 오는 거 싫어	0
드디어 차단을 했습니다	따지고 싶은데 참아야겠죠?	1
인강 듣는데 자꾸 딴짓하게돼	인강 듣는데 집중이 안돼	0
비는정말싫다	비참하네.	1
여자친구 쌩얼도 예뻐	여자친구 쌩얼 보고 배신감 느껴	1
남친 보여줄까	내 남자친구 보고 싶어?	0
좋아하는 사람이랑 같은 반 돼라	좋아하는 사람이랑 같은 반 돼라	0
겨울에 하는 이별	결국 다시 이렇게 됐네.	1
어떻게 해야 마음을 돌릴 수 있나	어떻게 받아들여야 할까?	1
면접 준비 어떻게 하지	면접 준비중이야	0
결정 못하겠어.	이제 결정해야 되는데	0
시험인데 집중 안돼	시험 기간인데 집중이 안돼	0
전화 걸어도 되나	전화해도 되겠지	0
썸이 너무 길어	썸이 너무 긴듯	0
눈 오니까 오빠 보고싶다.	눈 오는 날 추억 있는데	1
친구가 도와주는게 마음에 안들어	친구가 도와주고 있는데 마음에 안들어	0
지겹네	지금 이 순간. 너무 힘들어	1
오늘 다 끝냈습니다.	오늘 마지막 연락했습니다	1
남자친구가 적극적이지가 않아.	남자친구가 소극적이야.	0
절 찼던 여자애가 절 다시 좋아하는 건가요?	전여친하고 짝녀가 친구야.	1
어떨때 사랑하는구나 알아?	어떨때 사랑하는구나 알아?	0
짝사랑 중이었는데 솔로 탈출했어요.	짝사랑 중이었는데 솔로 탈출했어요.	0
짝녀 고민 들어줘.	짝녀 고민 들어줘.	0
좋아하는 여자 마음을 알다가도 모르겠어.	좋아하는 애한테 찌르기 눌러 버림.	1
영화 보자는데 나한테 관심 있나?	영화 보자는데 나한테 관심 있나?	0
잊혀져가는 모든 것이 그리워지네	자괴감만 드는 하루하루를 보내고 있습니다.	1
때려 치고 싶다	다 때려 치우고 싶어	0
베프랑 다툼	친한 친구랑 싸웠어	0
이별의 아픔 이겨내기	이별이 무서운건	1
오늘 보름달이야	보름달을 봤어	0
진담을 농담처럼 하는 사람	농담처럼 진담하는 사람	0
어젯밤 꿈을 꿨어	어쩌면 좋을까?	1
4년을 만난 여친이 떠났습니다.	4번의 재회와 4번의 헤어짐	1
썸인지 아닌지	썸인지 쌈인지	0
아무 생각 없이 쉬고 싶다	쉬는 날에는 쉬고 싶다	0
너 말이 좀 이상하다	너 말 제대로 못해?	0
리턴 다시 돌아오는 힘겨움	마음 정리가 되네.	1
좋아하는 사람 포기하는 방법 있어?	좋아하는 사람에 대한 감정이 이제 뭔지 잘 모르겠어.	1
너도 고민 있니	고민 있니	0
왜 상대는 아무렇지 않은 것 같지?	왜 차단이 안되있을까??	1
눈이 안 떠져	눈꺼풀이 무거워	0
왜 이제 찾는걸까?	왜 이제서야 찾아온거야?	0
상념	상처 받고 헤어졌습니다.	1
도시락 싸가지고 가야지	도시락 싸봐야지	0
헤어진 지 2주가 지났네.	헤어진건 아닌데	1
하 말 잘하는 애들 부러워	말 잘하는 법	0
나도 여자친구 있었으면	여자친구가 없어	0
자꾸 뒤처지는 느낌이야	나만 뒤처지는 느낌이야	0
하루에도 수십번.	하소연 좀 해도 되나	1
다른 사람 신경쓰는 시간 아까워.	시간 아까워.	0
회사에서도 친구가 필요해	회사에 친구가 없어	0
마음에 구멍이 난 느낌	마음대로 안되네	1
스테이크 먹고 싶어	스테이크 썰고 싶다	0
어장인거 알게 됐는데 포기해야겠지.	어장인거 알게 됐는데 포기해야겠지.	0
남편이 아기를 안 돌봐줘.	남편이 육아를 안해	0
짝녀한테 고백했는데 잘 됐으면.	짝녀한테 고백했는데 잘 됐으면.	0
아프고 또 아프지만	아프네	0
좋은 사람으로 남는다는것	주말은더 힘들어	1
머리 식히러 간 여행에서 되려 힘듦이 찾아오네	머리는 잊어야한다는데 마음이 붙잡는 미련	1
왜 이렇게 시간이 빨리 가지	좀 놀았더니 벌써 이시간	0
어제가 생일이었는데.	어젯밤 집 앞에서 잠깐 만났어.	1
깜깜한데 전기 안들어오네	전기 나갔다	0
아이돌 오빠들 좋아	아이돌 너무 좋아	0
배우자가 생긴다는 것	배우자가 생겨	0
남자들은 여자가 자기 좋아하는 거 알게 되면 어떻게 해? 싫지 않다면 받아줘?	남자친구 말고 다른 남자도 궁금해.	1
좋아하는 사람한테 관심 없는 척 하는 것도 이제 지쳐요.	좋아하는 사람한테 말 거는 방법?	1
연애의 끝은 결혼인거야?	연애의 끝은 결혼인거야?	0
나도 나이 들었나.너무 힘들다.	오늘 이상하게 힘들다	0
피부가 푸석하다	피부가 푸석푸석해	0
마지막으로 만나고 왔습니다.	마지막이겠죠	1
이성으로는 감당 할 수 없을 것 같아	이유라는게 뭔지	1
내가 원하는 사람이 되기 어려워	진짜 내가 되고 싶어	0
한때는 원망하고 화났었지만	한사람의 부재가 이렇게나 크게.	1
자격증 딸거야	자격증 따고 말테다	0
아무리 지쳐도 집에 가면 있는 내편	아무리 지쳐도 집에 가면 있는 내편	0
눈 뜨면 생각나는 사람	대출 엄청 끼고 집 사	0
점심 먹어야지	밥 먹어야지	0
소화제 먹어야겠다	소화제 먹어야 겠다	0
우리 반에 좋아하는 남자애가 있어.	우리 반에 좋아하는 남자애가 있어.	0
너무나도 힘들어	너무 화가 나네.	1
아이스크림 너무 비싸	아이스크림이 오랜만에 사먹는데 너무 비싸	0
원래 이별하면 이런건가?	위로가 되네	1
개당황	몰라서 당했어	0
이제 반년이란 시간이 흘렀는데	이제 스스로 인정한 것 같아	1
썸 타긴 하는데 어색한 사이야. 톡 어떻게 계속 이어가?	어색하게 썸타는데 카톡 어떻게 계속 이어가?	0
혼자 커피마셔	혼자만 힘드네.	1
연애 관계도 망	연휴가 시작되고 나니 더 생각나네	1
커피나 한 잔 하자고 말 해볼까	차 한 잔 하자고 해볼까	0
사랑을 노력한다는게 말이 되나요?	80년대 사랑에 대한 슬픈 노래좀 알려 주세요.	1
그냥 궁금해	그냥 만남과 헤어짐의 연속	1
여친 있는 짝남이 너무 친절하게 대해줘서 착각하게 돼요.	자꾸 다른 사람이랑 착각하게 돼요.	1
창업이라도 해야 겠지	나중에 창업해야 겠지	0
공부 왜 해야 돼?	공부하는 이유?	0
짝남한테 내일 영화보자고 말해도 될까?	짝남한테 내일 영화보자고 말해도 될까?	0
미안해 모든게 다 미안	미워하지않으려고.	1
짝사랑 시작하고 감정 기복이 심해.	짝사랑 시작하고 감정 기복이 심해.	0
피맥 땡긴다	집에 갈 때 피맥 먹고 싶다.	0
롱패딩 필요할까	롱패딩 살까	0
여친 진짜 예쁘다	여자친구가 너무 예뻐	0
친구 돌잔치 가는 중 	돌잔치 가야지	0
재회해도 또 그럴 듯	다시 만나도 또 그렇겠지	0
썸 타는 사이에 배낭여행 가능?	썸 타는 사이인데 답장 잘 안해1	0
개학하니까 좋다	방학 끝나서 좋아	0
아프니까 더생각나고 힘드네	아픔은 덜해지는것 같은데 미련은 더욱 많아지네	1
어제전화가왔습니다	어째서	1
쉬고 싶은데 회식 가야돼	일찍 가서 쉬고 싶은데 오늘 회식 잡혔어	0
빼빼로데이에 고백할까요?	빼빼로데이니까 장난인척고백할까요?	0
너무 좋은 경험 했네	암튼 종강이네	1
헤어지고 싶다	이별하러 가는 길	1
좋아하는 사람 있는데 내가 좀 소심해.	좋아하는 사람 환심 살 수 있는 방법 좀.	1
칼국수 어때?	매운 칼국수 고고?	0
짜증나게 해서 일단 나왔어	짜증나서 집 나왔어	0
연애 세포 깨우는 법	내 안에 연애 세포 깨우는 법	0
헤어진 여자친구를 돌아오게 하는 방법!	헤어진 여친 생각나서 노래 해바라기가 생각나네	1
그 사람이 나를 찾았으면 좋겠어	그녀가 지금 내 눈앞에 있습니다.	1
따듯하고 아름다운 여자이고 싶었는데	좋은게 좋은거겠지	1
더 이상 못할거 같아	여기까지가 한계인 거같아	0
처음 집근처에서 연애와 헤어짐	첫사랑 부모님 반대로 이별했습니다.	1
예쁘니까 좋아하나	예쁘니까 사랑하는 건가?	0
왜 나는 매번 이럴까	왜 이럴까	1
내가 좋아하는 여자애를 따라 좋아하는 애가 있음.	내가 좋아하는 여자애를 좋아하는 애가 있음.	0
정말 잔인하네	너무 잔인하다는 생각밖에	0
여친 과소비 심해	여친 과소비 심해	0
코가 간질간질	코 근질거려	0
줄 길거 같아	사람 많아서 기다려야할지도	0
이별.4주년	이별까지의 이야기.	1
막막하네.	몇일 동안의 나의 이야기.	1
중2 히스테리 알아?	눈썹 문신 어때?	1
지난주 이별했네	지쳐서 헤어진 남자랑은 재회가능성	1
결혼 준비하는 과정이 행복해	결혼날짜 받아왔어	1
추억에 머물다.	친구 사이로 지낸다는 게 말이 되나	1
김치볶음밥 먹어야지	김치볶음밥이나 만들어 먹어야지	0
모임에서 썸 깨졌는데	모임에서 썸타다 깨졌는데	0
이별을 실감하네	이별을 한지 조금 지나니 후회가 되네	1
나 좋아하는 여자애한테 답장이 안와.	톡 보냈는데 답장이 안와	0
짝녀가 차갑게 굴면 어떻게 해요?	짝녀가 차갑게 굴면 어떻게 해요?	0
썸 타는 여자가 있는데	회식하는데 나만 챙겨줘. 썸임?	1
사랑하는 거 힘들다	사랑하는 거 힘들다	0
보통 좋아하면 먼저 연락하나?	좋아하는 사람이 먼저 연락하는게 이상해?	0
결혼을 앞두고 있습니다	결혼적령기가 지나가는 거 같아	1
추우니까 나가기 싫어	너무 추워서 나가기 귀찮아	0
이상한 말을 해	왜 이상한 말 해	0
이거 사랑인가?	좋아하는 걸까?	0
썸 타기 좋은 알바 추천 좀.	썸 탈만한 알바 뭐가 있을까?	0
아프고 힘드네	아픈데 연락하기 싫어	1
이런 상황 어떻게 해석해야 할까?	이런경우.답은 나온거 같은데.	1
여자친구 여신같아	여자친구 오늘 여신같았어	0
사랑에 빠지고 싶다	사랑하는 사람 있었으면	0
공무원 시험 죽을 거 같아	공무원 시험 힘들어ㅠㅠ	0
썸인가? 애매한 거 싫어.	썸인가? 애매한 거 싫어.	0
나중에 뭐하고 먹고 사냐	나중에 뭐할까 고민이야	0
답 없는 내 인생	내 인생 답 없어	0
추석에 집에 가기 싫어	추석 가기 싫어	0
짝남한테 여러 번 차이다가 나중에 사귀게 된 사람도 있을까?	짝남한테 여러 번 차이다가 나중에 사귀게 된 사람도 있을까?	0
귀여운 집착은 사랑을 더 뜨겁게 해주나요?	사랑에 관련된 노래 듣고 싶어	1
이러면 안되는 줄 알면서도	이런 사랑도 있나	1
또 하루가 저물어가네	똑같은 이별	1
애정운 궁금하다	갑자기 올 해 애정운이 궁금하다	0
연말이라 그런지	연하의 남자친구와 이별 후 5일째 입니다.	1
동거해도 될까?	동거하자고 말해도 될까?	0
남자친구가 사진 실력 꽝	남자친구가 사진을 너무 못 찍어	0
부장님 눈치 보여	짤릴 것 같아	1
발표 준비 너무 힘들어	발표 준비하느라 힘들어	0
사람을 잊는다는 것에 대한 모순	사랑 하기 때문에 떠난다는 말?	1
다른 남자들도 그럴까?	다른 사람을 만나도 채워지지 않아	1
이럴 수도 있구나?	이만 보내줘야 할까?	1
1년전 그 날	2년 가까이 여친하구 헤어졌습니다	1
셀프웨딩 힘든만큼 보람될까?	셀프웨딩 힘들겠지	0
연락하는 게 어색해	연락하는 게 익숙하지가 않아	0
썸 타는 사이인데 카톡하다가 마무리 어떻게 해?	썸 타는 사이인데 카톡 마무리 어떻게 해?	0
물질적인 정리는 다했는데	뭔가 무섭다	1
불면증인가	왜 잠을 못 자는 걸까?	0
다 잘해	못하는 게 없는 사람	0
문 잠겼는데 집에 아무도 없네	문득문득 보고 싶어요	1
새벽 3시	새사람을 만날 듯, 전 여친에게 미안해	1
차단한 카톡	착각이였나보네ㅋㅋ	1
커피를 너무 많이 마셔	커피가 좋아	0
역시 못잊겠습니다.	연락 왔는데 끝냈어	1
옆에 있는 사람한테 너무 소홀했던거 같아	옆에 있는 사람이 중요해	0
나그네	마음 한켠엔 구멍이 남아있네.	1
머리가 좀 아프다.	머리 아픈 거 같애	0
끝나면 좋을 줄 알았는데.	다 끝나가니 좋을줄만 알았는데.	0
학교 가고 싶지 읺은데 어디 가지	학교 가기 싫은데 딴 데 어디 갈까	0
연락하고 싶은 충동	연락했는데 실수한거 같네	1
사수가 일을 너무 못하네	일 못하는 사수랑 일하는 거 힘드네	0
계속 보고 싶어	계속 보고 싶으면 어떡해?	0
손톱이나 깎아야지	손톱이나 짧게 깎아야지	0
관심 끄라고 하고 싶다.	관심 좀 안 가졌으면	0
참지 못하고 또 친추를 하고	첫만남 그리고 끝	1
결혼 상대로 괜찮을까?	결혼하기로 한거야?	1
진짜 나를 좋아하는 남자랑 사귈 걸.	진짜 나를 좋아하는 남자랑 사귈 걸.	0
남편을 자꾸 무시하게 돼	남편이 이상한 말 하니까 자꾸 무시하게 돼	0
담배피는게 싫어.	남친 담배 좀 끊었으면.	0
좋아하는지 확인하고 싶다	술 그만 먹으라고 잔소리 하고 싶어	1
40을 목전에 둔 헤어짐	4년 반이라는 시간이 이렇게 끝나네.	1
저금해야 되는데	적금 조금이라도 부어야겠지	1
남의 일 도와줘야 할까	내 일 아닌데 해야 돼?	0
마지막 선물.	마지막 카톡을 보냈어	1
패턴 궁금해	전화 패턴 궁금해	0
매주 수요일 그녀를 만날 수 있어.	매주 수요일 그녀를 만나.	0
짝녀 잊으려면 인스타부터 안 해야할듯.	짝녀 잊으려면 인스타부터 안 해야할듯.	0
예전에는 비슷했는데	어렸을때는 비슷했던 거 같은데	0
코자	잘자	0
짝녀가 운동을 한다는데 같이 하고싶어	짝녀가 운동을 한다는데 같이 하고싶어	0
연락 안오면 어쩌나 걱정되네	연락 안오면 걱정돼	0
못된 사람	무너진 밤 	1
헤어진지 한달	헤어짐 통보 당한지 1달 정도 지났네	1
조별 과제 발표 하기 싫어	조별 발표 하기 싫어	0
그냥 씹어야겠다.	잠수가 취미	0
정말이지 이렇게 살고 싶지 않네	정신차려야 하는거 아는데.	1
7일차	8년 만났는데 어떻게 헤어져	1
즐거운 추석 보내	즐거운 추석되세요	1
변하지 않는 사람도 있겠지?	더 깊어지고 편해졌어	1
집 샀어	새 집 샀어	0
후회스럽습니다.	휴. 생일인데 기운빠지네	1
사과를 안해	사과할 사람은 사과를 안해	0
남들이 다 겪는 그저그런 8년의 사랑이야기.	남자들은 원래 이런가?	1
아예 일찍 출근하면 되겠지.	아예 일찍 출근해야지	0
해외여행하다 숙소에서 만난 외국인이 너무 좋은데 이 연애 무리일까?	해외여행하다 만난 외국인이 너무 좋은데 이 연애 무리일까?	0
사귀기로 했는데 존댓말 계속 써도 돼?	사귀면서 존댓말 더 기분 좋을까?	0
좋아하는 사람이 있는데 종교가 달라.	좋아하는 사람이 있는데 종교가 달라.	0
반배정부터 올해 끝났다.	반배정 망했어	0
썸 두달 넘었는데	썸만 두달 넘었는데 어떻할까	0
사투리쓰는게 귀여워	사투리 귀여워	0
연애2년차.헤어졌습니다.	영원한 사랑은 없는걸까	1
이젠 포기가 되네	이혼을 준비중인 부부라면	1
텅빔	툭하면 헤어지자라는 말을 하는 사람	1
잘 헤어졌는데 너무힘들어	잘지내고 있는지 궁금해지네	1
4년 사귄 여자친구가 환승 이별했어	4년 4개월간의 사랑이 끝났네	1
친구라고 생각했는데	친구라고 생각했는데 날 엄청 쉽게 생각했나봐	0
화장하니까 어때?	화장빨인가	1
먼지 지수 어때	먼지가 많나	0
공무원 되면 좋겠다	공무원 되고 싶다	0
썸 깬 거 후회해.	괜히 고백한거 후회해.	0
다시 만나자면 만나줄까	다시 만나자면 만나줄까	0
클스마스에 할일	크리스마스에 뭐 하나	0
은행 대출 받을까봐	대출받아도 괜찮을까	0
동물을 너무 좋아해	고양이 너무 좋아해	0
배고프당	배고파	0
올해 계속 안 좋네	올해 왜 이러지	0
집 가는 중	집에 간다	0
괴물이 되어 가는 느낌이 들어	나 점점 괴물이 되고 있어	0
매번 헤어지면서 회의감	매일 그립습니다	1
좋아하는 사람이 날 너무 편하게 생각해.	좋아하는 사람이 날 너무 편하게 생각해.	0
남자친구가 연애하는데 가끔씩 막말을 해.	연애하는데 가끔씩 막말을 해.	0
파혼	평생 내꺼일거 같아서 함부로 했습니다.	1
그 사람과 나의 사랑하는 정도의 차이 	이제 제 사랑을 소중히 해 줄 사람을 찾고 싶습니다	1
남자친구가 힘들어 해	남자친구가 요즘 너무 힘들어 해	0
사귀면 좋을까	사귈까	0
썸남이랑 헬스장에서 운동 가능?	썸남이랑 헬스장에서 운동 가능?	0
사랑이란거 하고 받고싶은데,.	사업 시작해도 될까	1
언니랑 전쟁 중	언니랑 다퉜어	0
어둠아 끝나라	어둠의끝	0
또 눈 내려	눈 또 와	0
매달린후 2주째 발신자제한	매순간 넘 보고 싶어	1
남편이 축가 불러준대	내 친구랑 내 짝녀가 서로 좋아하는 것 같은데 나 어떡함?	1
기다리라고 말 못하겠어	기다리라고 못 말하겠어	0
스타벅스 같은데 가봤어?	스타벅스 가봤어?	0
몸이 천근만근이다	몸이 무거워	0
변명거리가 생각이 안나	변명거리 생각해봐	0
너무 보고 싶어 살려줘.	너무 슬퍼 잠못들어 보내지 못하는 글을 올려봅니다	1
결혼 준비중 일방적인 이별통보 살기 싫어져.	결혼적령기의 여자는 이기적이에요.	1
눈물이 나고 마음이 아픕니다.	왜 이렇게 눈물이 나지?	1
짝녀 기분이 안좋아 보여서 신경 쓰임.	짝녀 기분이 안좋아 보여서 신경 쓰임.	0
꿈이 없어	나만 꿈 없이 사는 거 같아	0
내 잘못인 거 같은데 어떻게 털어놓지	내 잘못인 거 같은데 말을 못하겠어	0
짝사랑 하는 여자한테 고백한다? 안한다?	짝사랑 하는 여자한테 고백한다? 안한다?	0
막 말하는 거 좀 고치지 짜증나.	막말하고 자기는 까먹어.	0
쉬는날인데 왜 만나자고 안하지	쉬는날인데 왜 만나자는 말을 안하지	0
친구가 자꾸 클럽을 너무 좋아해 맨날 가재	친구가 자꾸 클럽가자 해	0
동생이 나 제끼고 결혼하겠대	동생이 먼저 결혼하겠대	0
친구들하고 욕하고 있는데 짝녀가 들었어.	친구들하고 욕하고 있는데 짝녀가 들었어.	0
중소기업이라도 취직할까?	중소기업인데 그냥 취직할까?	0
씨씨인데 몰래 만나고 있는데 공개 연애 하자고 할까?	씨씨인데 공개 연애 하자고 할까?	0
여자친구가 자꾸 애 취급해요	여지친구 만나러 가는 길	1
떠나간 전여친 지나가다 봤네.	떡볶이 좋아하지도 않는데	1
첫데이트 어디로 가는게 좋을까?	첫데이트 어디로 가는게 좋을까?	0
그렇게 할래	그래 그러자	0
새 집으로 이사 가기로 했어	새 집 가기로 했어	0
매일매일 눈물로 보내	머리가 터질거 같습니다	1
2년 만난 기념일이야	우리 벌써 2년 동안 사궜어	0
파도 엄청나다	파도 장난 아니다	0
휴대폰 초기화 해야돼	폰 초기화 해야지	0
유기견 분양 받으려고	유기견 입양하려고	0
전화하기엔 늦은 시간인데 전화하고 싶어	전화하기 너무 늦나	0
주변사람들에게 너무 미안합니다.	죽겠다 진짜	1
이별후 사진을 못지우겠네	이별후 한달	1
짝사랑 하는 상대가 나를 싫어하는 것 같애.	짝사랑 하는 상대가 나를 싫어하는 것 같애.	0
우리 사랑이 영원했으면 좋겠어	우리 사랑이 영원했으면 좋겠어	0
사랑이라는 감정이 참 묘한거 같아	일하러 나왔는데 손에 안 잡히네	1
내가 기대를 너무 많이 했나봐	너무 기대했나봐	0
기획사니까 당연히 예쁜 애들 많겠지	기획사에 예쁜 애들 많겠지	0
좋아하는 사람에 대한 생각 비우는 방법 좀 알려줘요.	좋아하는 사람을 싫어하는 척하고 있는데 우울해.	1
면허 따야하나	면허 딸까봐	0
생각할수록 진짜 화나고 분하네 3년을 만나고 전화로 이별통보	서로 위로하며 함께 극복할 사람	1
이제 정리하려고 합니다.	이제 진짜 떠나야겠지	1
이제 나도 계산적인 사람이 되려나 봅니다	이제 누구 만나는 것도 지치네	1
드디어 해외 여행 간다	처음 해외여행가!	0
썸인지 아닌지 확신이 안들어	썸인지 아닌지 알 수 있나	0
점심시간에 은행 갔다와야지	점심 때 은행 갔다와야지	0
진짜 끝	진짜 어이없고 화 나내	1
어쩔수 없는	언제가 제이야기 한번 들어줄 날이오겠죠?	1
봄되니까 집에 먼지가 너무 많아	청소를 안 했더니 먼지 쌓였어	0
안경 빼니까 예뻐보여	안경 빼니까 다른 사람	0
상사병 극복하고 싶어	상사병 걸린거 같아	0
이별후 자주듣는 노래있으신가?	이별후.	1
카드 너무 많이써 이제 현금만 써야겠다.	현금만 쓸까봐	0
정말 힘듭니다	정말로 헤어졌습니다	1
오늘 가는 모임에 짝남이 있는데.	오늘 가는 모임에 그 사람이 있는데.	0
좋아하는데도 헤어지자네요.	좋아하는데도 헤어지자네요.	0
마른 기침이 계속 나오네	마른 기침 나와	0
사귀던 사람이 잠수탔어	사귀던 사람이 잠수탔어	0
사귀고 나서 외모에 신경을 너무 안 써	외모에 신경을 너무 안 써	0
건강이 최고인 것 같아	건강이 최고	0
짝녀가 우리 과에서 인기가 너무 많아.	짝녀가 우리 과에서 인기가 너무 많아.	0
좋아하게 됐어	결국 사랑이었어	0
썸의 조건이 뭐야	썸의 기준이 뭐야	0
먼저 인사할까 했는데 짝녀가 먼저 인사해줬어.	짝녀가 먼저 인사해줬어.	0
대빵 큰 여드름 올라와	여드름 났어	0
적금 들고 나니까 돈 없어.	적금 들어야 되는데..	1
썸타고 있어요	썸타고 있어요	0
헤어지고 시간이흘렀네,	헤어지고 힘들다.	1
선배가 나만 챙겨 주는 것 같은데 좋아하나	선배가 잘 챙겨주는데 그냥 그런 거겠지.	0
이별6일차. 정신병자 같네.	이별로부터 언제쯤 자유로워질까	1
스팸 문자 계속 와	스팸 문자 많이 오네	0
그 사람이 뭐하는지 궁금해.	그녀는 내 마음을 알까?	1
내일은 비왔으면 좋겠다.	내일 비왔으면	0
최소 썸인 듯.	이건 최소 썸인 듯.	0
고백한 애가 연락이 느려.	고백한 애가 톡이 느려.	0
누구나 가슴속에 있는 전화번호.	눈물이 계속 나와	1
사람들이 나 좀 좋아해줬으면	나 좀 좋아해줬으면	0
요즘 눈에 띄는 여자애	요즘 눈에 띄는 여자애가 있는데	0
짝녀가 좋아하는거 눈치 1도 못챔.	짝녀가 좋아하는거 눈치 1도 못챔.	0
명절 다가오니까 스트레스	명절 스트레스	0
셀프 신행준비 팁 알려줘	신행준비 혼자 할 수 있을까?	0
여친 있는데 다른 여자랑 썸 가능?	썸인거 같은데 회사에서 가능한건가 	1
이직 성공할 수 있을까	이직해도 될까	0
휴대폰 액정 깨졌어	액정 깨짐	0
비 오는 날은 만나서 뭐할까	비 오는 날 데이트	0
아직도 적응이 안되네	아침부터 답답하네	1
행복은 어디있어?	행복해지고 싶어	0
헤어진지 2달째	헤어진지 3개월째입니다.	1
날 좋아하는 여자애가 갑자기 뜸하네	날 좋아하던 남자애가 고백이 없는데 맘 접은걸까?	0
나를 떠보는 것 같은 짝남.	슬쩍 떠보는 것 같은데	0
피부가 점점 늙어가는게 느껴져	피부가 늙은 듯	0
어제 짝녀랑 데이트했는데 꿈만 같습니다.	짝사랑만 하다가 어제 드디어 데이트했는데 꿈만 같습니다.	0
남편이 나를 사랑한대	남편이 사랑한대	0
사랑을 너무 많이 받고 있어 매우 행복하다.	세일하는데 살까	1
점점 모질어진다.	성격이 점점 날카로워져	0
비밀 지켜줄까?	비밀 지킬 수 있을까	0
새로운 일 벌려도 될까	새로운 일 해도 될까	0
비밀번호 뭐였더라	혼자 살아야 할 듯	1
즉흥적인 여자친구가 고민임.	즉흥적인 여자친구가 고민임.	0
학원 다른반에 좋아하는 사람이 있는데 번호를 알고 싶은데 방법 좀 알려주세요.	학원 다른반에 좋아하는 사람이 있는데 번호 어떻게 알아내지	0
생리통 때문에 배 아파	공부는 내 체질이 아닌 것 같아	1
이미 접은 짝남한테 주기적으로 연락이 온다.	이미 접은 짝남한테 주기적으로 연락이 온다.	0
목욕탕 가서 때밀어야겠다.	목욕탕 가야지	0
티 나게 어색해 했어	어색한게 얼굴에 티 나	0
한결같이 출근하기 싫어	직장 너무너무 가기 싫어	0
첫사랑 생각만해도 아련해	첫사랑 생각나	0
미세먼지 지수 어떻대?	오늘 미세먼지 어때?	0
좋아하는 오빠 페북 친구도 안되어있는데 실수로 댓글 달았어요.	좋아하는 오빠 페북 친구도 안되어있는데 실수로 댓글 달았어요.	0
좋아하는데 티조차 못내는게 마음 아파요.	좋아하는데 티조차 못내는게 마음 아파요.	0
이별 일주일차	이별 준비 중	1
휴식 중	간만에 휴식 중	0
음악이싫어졌어	의심이 자꾸 들어	1
헤어진지 11개월 째인데 연락이 안돼	헤어진지 1년이 넘었네.	1
정말 슬프고 죽고싶어	정말 웃긴건	1
이성의 학교선배와 단둘이 식사한다면 어떻게 해?	이제 내 짝남 못봐. 군대 가거든.	1
너무 늦은 깨달음	너무 답답해서 글을 써봅니다	1
오늘 따라 그 친구가 좀 보고싶네	오늘 무너졌어.	1
마음 잡고 다시 시작	마음 잡고 고고씽	0
썸 타는 사람 생일선물 오바인가?	썸 타는 사람 생선 준비 오바임?	0
짝남 프사랑 비슷한거 하고 싶은데 해도 될까?	짝남 프사랑 비슷한거 하고 싶은데 해도 될까?	0
아침 꼭꼭 먹어야지	아침 챙겨 먹어야지	0
잊고싶다.	잊는다는거 참 어렵네	1
결국 헤어짐이 찾아오네	결혼 가치관 때문에 헤어졌네.	1
짝남한테 문자 왔어.	짝남한테 문자 왔어.	0
날씨 건조한 거 같애	오늘 좀 건조한 거 같애	0
집중이 왜 이렇게 안 돼지	집중이 안돼	0
다가오는 크리마스	다들 힘들겠지	1
노래방 가고 싶다.	코인 노래방 가서 몇 곡만 부르고 와야지	1
왼손잡이가 뭐 어때서	왼손잡이가 잘못이야?	0
사랑이라는 이름으로 주는 상처	사랑이라는 이름으로 상처 줬어	0
사랑하면서 외로워	사랑하면서 외로워	0
잘 사귀는데 불안한 느낌이 들면 정상일까?	잘 사귀는데 불안한 느낌이 들어	0
술마시면 안되는데	술먹고 집앞에 찾아온남자	1
끼 부리는 사람 어때?	나 부담스러워하면 어쩌지?	1
사랑에 서툴어	사랑에 서툴어	0
낼 짝녀한테 잘 보이고 싶어.	낼 짝녀한테 잘 보이고 싶어.	0
사랑할 때도 용기가 필요하지?	사랑한다고 말하는 데는 용기가 필요하지?	0
짝남이 넘 귀여워.	짝남이 넘 귀여워.	0
머릿결 좀 찰랑거렸으면 좋겠어.	찰랑찰랑한 머릿결 갖고 싶다	0
결혼하면 남편한테 사랑받겠다.	남자는 아무리 좋아하고 사랑해도 혼자만의 시간이 필요한가요?	1
자기를 아껴주고 사랑해주는 사람의 마음을 이용하는 사람.	자꾸 생각나고 붙잡을수도 없고.	1
잘참아왔는데 눈물 흘렸네.	잠겨 죽어도 좋으니 너는 물처럼 내게 밀려오라.	1
머리가 띵한게 한 대 맞은거 같아	머리가 띵해	0
감 말랭이 먹고 싶다.	감 말랭이 먹어야지	0
일주일간 괜찮았는데.	입원 중에 이별통보 받았는데 마이 아프네	1
하고 싶은 건 많은 데	하고 싶은 게 많아	0
집안일을 못하겠어	집안일 어려워	0
졸업식에 가야하나	졸업식에 안가면 안되나	0
썸 탈 때 단답이나 줄임말 쓰지마?	썸 탈 때 단답 쓰지마?	0
이 행복이 사라질까 두려워	지금 이 행복이 사라질까 두려워	0
5년이 넘게 만난 첫 연인, 그리고 이별	6개월 가량의 이별과 재회의 끝	1
이별은 진짜 비겁한 짓 같아.	이별을 고민중입니다.	1
시어머니가 같이 목욕탕 가재	시어머니가 같이 목욕탕 가재	0
도대체 사랑이 뭐니?	도대체 사랑이 뭔지 모르겠어?	0
뭐하는 분이세요?	너 누구?	0
새해 복마니 받아	생각할 시간을 갖자는 그녀	1
내 배우자도 어디 있을까?	내 배우자는 어디 있을까	0
결혼 전에 다이어트 해야겠지?	결혼 준비하면서 많이 싸워?	1
온종일 멍하네	완전 헤어짐 극복 방법 있을까	1
희생양 된 느낌	내가 희생양이 됐어	0
썸에도 유통기한이 있어?	썸에도 유통기한이 있어?	0
사랑은 돌아오는 거야?	사랑은 돌아오는 거야?	0
전 왜 제 마음도 잘 모르는 걸까요.	내 마음도 잘 모르겠어요.	0
너무 힘이 들고 내 자신이 한심해	너무너무 답답하네	1
사내커플인데 비밀연애임. 답답해.	비밀연애임. 답답해.	0
고작 사람 하나인데	공허하네	1
원래 장난도 잘하고 재밌다고들 하는데 그녀 앞에선 작아지는데 어떡해.	원래 장난도 잘치는데 그녀 앞에선 작아지는데 어떡해.	0
이제는 포기하게 되네 나 자신조차	이제야 오래전 상대방이 아팠던걸 이해했어.	1
좋아하는 사람한테 티 안내는 사람 어떻게 생각해?	좋아하는 사람한테 티 안내는 사람 어떻게 생각해?	0
안 좋아하는데 계속 만나는 거 가능?	혼자가 편하다는 짝남에게 먼저 대쉬해버림.	1
사랑을 기다리고 있어	사랑을 기다리고 있어	0
외로움	외롭고 우울해서 잠이쏟아져	1
습관 고치는 거 너무 어려워	습관을 고치기 어려워	0
생각한 데로 안돼서 고민이다.	뜻밖의 고민을 하고 있어	0
내가 좋아하는 애를 내 친구가 좋아하는게 맘에 안 들어.	내가 좋아하는 애를 내 친구가 좋아하는게 맘에 안 들어.	0
어장인거 알겠는데 포기가 안돼.	어장인거 아는데도 좋아해.	0
남자 궁금 해.	남자친구가 이별준비를 하는 것 같아	1
썸 오래타면 오래 못 사겨?	썸만 오래 타니까 가슴이 탄다.	1
완전 좌절이다.	좌절 중이야	0
마스크 쓰고 번호 따는 건 뭐냐	아침 조깅 중	1
피자 식어서 왔어	피자 배달 왔는데 다 식었네	0
슬픔활용법.	시간을 갖자는 무슨 의미일까?	1
믿은 내가 바보지	바람 나서 떠난 여친이 전화왓네.	1
화를 잘 못 참겠어	화를 잘 못 참겠어	0
니가 생각나긴나	결국 이렇게 되는건가	1
눈이 자꾸 마주쳐	대학교에서 첫사랑 다시 만났어.	1
어플로 만난 남자친구 계속 만나는게 맞는걸까?	어플로 만난 남자친구 계속 만날까?	0
새학기 준비 좀 해볼까	새학기 준비해야지	0
친한 동생인데 짝남이 되고 있는 느낌이에요.	친한 동생인데 짝남이 되고 있는 느낌이에요.	0
집에 빨랑 가고 싶다	집에 일찍 가고 싶다	0
야경 보고 싶다	야경 보러 가고 싶다	0
소화도 안되고 가슴 한 켠에 응어리가 있는 거 같네.	솔직히 그녀가 미친듯이 불행했으면 좋겠다.	1
뭐 입고 나가지?	뭐 입고 가지?	0
사랑이 뭔지 넌 알아?	넌 사랑이 뭔지 알아?	0
봄 타나 봄.	봄 타는 것 같아	0
잘 맞는 사람 만나고 싶다	나랑 죽이 잘 맞는 사람 만나고 싶다	0
머리 안감았더니 떡졌어	앞머리 떡졌어	0
비행기 타러 공항 간다	비행기 타러 간다!	0
결혼생활에 회의감이 들어	결혼한게 후회돼	0
좋아하는 애랑 관련된 흑역사가 많은데.	좋아하는 애랑 관련된 흑역사가 많은데.	0
날씨 죽인다	오늘 날씨 죽인다	0
헤어진지 40일째	헤어진지 6개월	1
결혼하는데 돈 얼마나 들까	결혼준비하는데 돈 얼마나 드나	0
스킨십 어떻게 생각해?	스킨십 어떻해?	0
패턴 알고 싶다.	패턴 물어볼까	1
이별. 성숙해지다	이별곧 두달.	1
드디어 천일	오늘이 천일이네	0
아무리 미친놈 욕을해도	아직 멀었나봐	1
여자는 한번 마음 먹으면 끝인가?	여자친구가 나 때매 힘들대	1
너는 안자?	자니?	0
시험 공부 언제 다함	시험 공부 큰일	0
회사에 빨리 적응해야 할텐데	회사에 적응 잘 하고 싶어	0
예쁘면 다냐ㅠㅠ	예쁘면 다냐	0
사랑이 어떻게 변하니	사랑이 어떻게 변하니	0
으아 떨려	떨리나봐	0
진짜 완전체가 있어	회사에 완전체가 있어	0
유부녀 됐어!	유부녀 됐어!	0
권태기 .	권태기로 헤어지면 후회할까	1
연락 좀 빨리빨리 했으면 좋겠다.	연락 좀 빨리 하지	0
현금만 써야겠다.	현금만 쓸까봐	0
세달 끝에 재회 실패	세상이 다 그렇지 뭐	1
정신이 없어	정신차리자 정신!!	0
남자친구 카톡 말투가 마음에 안 들어.	남자친구 카톡할 때 말이 참 안 예뻐.	0
남자들은 관심 없으면 보통 연락 먼저 안해?	남자에게 첫사랑이란?	1
좋아하지 않는데 계속 연락하고 만나는거 가능한가.	좋아하지 않는데 계속 연락하고 만나는거 가능한가.	0
짜장면 시켰어	블랙데이인데 짜장면 같이 먹을 사람이 없어	0
결혼 전에 혼란스러워	결혼 해도 되는지 고민돼	1
청첩장 골랐어	청첩장 고르고 있어	0
아이고 의미 없다.	의미 없어	0
아 잠수라니	아.빌어먹을 이제야 알다니.	1
남자친구가 너무 객관적이야.	남자친구가 너무 객관적인 말만 해	0
썸 타다가 말도 안하고 잠수 타는 경우 뭐야?	썸 타다가 잠수 타는 경우 뭐야?	0
여자친구를 믿는데 가끔 의심이 가.	여자친구를 믿는데 가끔 의심이 가.	0
이기적인 사람을 좋아하는 거	이기적인 사람을 좋아하는 거	0
친구가 소심해	친구가 엄청 소심해	0
후회 안해야 할텐데	앞으로 어떻게 살지?	0
오늘은 제 미련한 인생을 주절거려보렵니다.	오래 사귀다가 식어서 헤어진 남자에게도 후폭풍 있나?	1
머리카락 쑥쑥 빠지는 느낌	머리카락 많이 빠져	0
지금 내가 해야 할 것	뭐하면 시간이 잘 갈까	0
혼자만 설레고 혼자서 끝내는 짝사랑 그만할래.	짝사랑 그만할래.	0
겁이 납니다.	결국 결혼에 골인 못하고 헤어졌습니다	1
답정녀 안 만나는 방법 있나.	답정녀 퇴치법	0
헤어진지 43일	헤어진지 6개월이 넘어가네.	1
인턴 원서 넣어 볼까	인턴 할까	0
다른 과랑 복전하고 싶어	취직하려면 복수전공해야 할 것 같아. 	0
오늘도 연락을 기다리는 나	오늘도 포장마차	1
사랑하는 정도의 차이 	제 사랑을 소중히 해 줄 사람을 찾고 싶습니다	1
첫눈 오는날 만나고 싶다	첫눈이 올때 같이 있고 싶다	0
고의는 아닌데 실수를 한 거 같아	친구한테 실수한 거 같아	0
사랑한걸까?	사랑하긴 한걸까?	0
운동을 하는 남자가 좋아	운동을 하는 남자가 좋아	0
운동 다녀왔어.	웃기지마 넌 쓰레기야	1
1년동거 끝에 헤어짐	1년만의 연애가 끝났네	1
내가 좋아하는 사람이 나를 신경쓰게 하는 방법 조언 좀.	나를 존재감을 알리는 방법 조언 좀.	0
또 못 만났어	오늘 못 만났어	0
오늘 길 많이 막히더라	오늘 길 너무 막히더라	0
어이가 없어서	어이없어	0
받아들이기가 많이 힘드네	밤에 잠이 너무 안와여	1
어리석은 나	어제 만났어	1
너무 예민한 여자친구	너무 예민한 여자친구 어떻게 해	0
남편이 이상해	내 친구들이 다 별로라고 하는 짝녀 나만 좋다면 연락하는게 맞는걸까?	1
옷 걸 데가 없어	옷장이 점점 줄어들어	0
3년 사겼어	3년째 연애 중	0
헤어짐이 힘든이유	혜진아. 내 맘이 너에게 확정되기 전에 날 떠났어야지	1
너 가족 관계 어떻게 돼	너 가족 누구누구 있어?	0
연락 또 해도 되겠지	연락 많이 해도 되겠지	0
밉게 보였으면 좋겠어	바람난 여자친구 사람 고쳐 쓰는거 아니네	1
이제 바람 분다	바람 분다	0
배고프면 예민함?	공복이면 예민함?	0
썸남이 톡이 느려	썸남이 톡이 느려	0
옆집 데이트 폭력 같아	강아지 있나봐 옆집 소음 너무 심해	1
불만이 너무 많아	불만을 입에 달고 다니는 사람 때문에 고민이야	0
마음을 정리하는 중인데 카톡 왔어	마음을 정리하고 있는데 뜻밖의 남자가 카톡을 했네	0
조금 아픈가 보다 아주 쪼금	조만간 다른 사람 만날꺼 같아	1
예쁜데 연애 안하는 여자	예쁜데 연애 안하는 여자	0
다이어트해야 되는데	다이어트 성공하고 싶은데	0
뭔 참견이야	참견 좀 하지마	0
헤어진 여자친구가 준 편지 못 버리겠어	옛여자친구가 준 편지 못 버리겠어	0
이 행동이 용납이 안돼나.?	용납할 수 없는 행동	1
의미부여 안해야하는걸 아는데 자꾸 하게 되네ㅠ	이 또한 지나가겠죠	1
웹툰 뭐 볼까	웹툰 추천해줘	0
최근에 헤어진 짝녀한테 연락하면 내 연락을 받아줄까?	최근에 헤어진 짝남한테 지금 연락하기는 너무 이를까?	0
롱디인데 너무 보고 싶어.	너무 보고 싶은데 롱디	0
정동진 가서 바람이나 쐬야겠다.	바람쐬러 정동진가~~	0
재회 했는데 실패	세상일이 뜻대로 되지 않는 듯	1
병원 너무 가기 싫다	병원 가기 싫어	0
왜 때문에 나만 시키냐고	왜 나만 시키지	0
사랑이 영원할 거라 믿고 싶어	이 사랑 영원할 거라고 믿고 싶어	0
답답해서	당신이 너무 원망스럽습니다.	1
내가 제일 문제인 듯	내가 아무것도 아닌 사람 같아	0
공시준비중	공시생이야	0
미안하고 보고 싶습니다	미운감정 어떻게 하나	1
마음을 아무리 밀어내도 안돼	내 마음을 아무리 밀어내도 안돼	0
짝남이랑 동생 이름이 똑같아.	짝남이 좋아하는애 있거나 여친 있으면 포기하는 이유가 뭐야?	1
신경쓰지 말아줄래 라고 하네	심난하네	1
헬스장에 운동 오는 사람 많네	헬스장에 사람이 엄청 많음	0
빼빼로 만들어주는 거 좋아할까?	빼빼로 만들어주면 좋아할까?	0
좋아하는데 전혀 티 안내는게 가능할까요?	좋아하는데 전혀 티 안내는게 가능할까요?	0
혼자 살 수 있을까	혼자 살아도 될까	0
한숨만	할 말이 많은데.	1
그 사람이 참 그리워	그냥 가슴이 아프네	1
알바 해야겠어	알바 자리 구해 봐야겠다.	0
눈물이 말랐는지 슬퍼도 감정이안나오네	니가 독한거니 내가 찌질한거니	1
오늘도 짝사랑하는 여자 땜에 술 마시는 중.	짝녀 땜에 술 마시는 중.	0
괜찮아졌는줄 알았는데. . .	괜찮은 줄 알았는데	0
환승이였다는걸 알고서 .	회사선배랑 바람나서 헤어졌어	1
월급 받아서 주택청약 들었어	주택청약 들었어	0
내가 집착하는 걸까?	내가 집착하는 걸까?	0
어색해서 죽을뻔	너무 어색하더라	1
썸녀 주변에 남자가 많아	주변에 남자가 많아	0
나도 위로해 줄 사람 필요해.	위로 좀 해줘.	0
다시 만나고 싶어	담담하게 헤어졌어	1
썸 타는 사람 있는데 불안해.	썸 타는 사람 있는데 불안해.	0
지금 연락 왔어	지나가는 말이 가슴을 후벼파	1
눈물이 많아졌어	나이들면서 눈물이 많아졌어	0
여자친구의 핸드폰 저장명을 뭐로 하지?	여자친구의 핸드폰 저장명을 뭐로 하지?	0
남친 있는 짝녀가 친절한데 무슨 의미일까요?	짝녀가 남자친구 있는데 요즘 나한테 친절하다	0
너무 상처를받아서	너무 우울하네	1
공부 시작해도 될까	새로운 공부 시작해도 될까	0
아이돌이 여친이면 좋겠다.	내 여자친구 아이돌이야	0
연애세포가 다 죽었나	연애세포가 다 죽었나	0
아무것도 하기 싫어	아무리 생각 안하려 해도	1
짝남한테 같이 스터디하자고 해도 될까요?	짝남한테 같이 스터디하자고 해도 될까요?	0
추운날씨.	친구도 연인도 아닌 그런사이의 끝	1
전하지 못 할 편지	점점 나도 지쳐가네.	1
성숙한 사랑은 뭘까?	어른 같은 사랑은 뭘까?	0
혼자 썸타는 기분이야.	혼자 썸타는 기분이야.	0
오늘나 어제이나 똑같아	오늘도 어제랑 똑같아	0
그런 사람인가보다 해야하나봐	그런 사람인갑다 해야지	0
아직도 심장이 뛰고있어.	아직도 헷갈리네	1
남자친구가 욕함	남자친구가 홧김에 욕함	0
내가 이래뵈도 괜찮은 사람인데	나도 괜찮은 사람인데	0
으악 소리 지르고 싶다	소리지르고 싶어	0
동생한테 짜증냈어	동생한테 화냈어	0
이별하는게 맞는거겠죠	이별한지 1년하고 2개월지나갑니다	1
전남친 마주쳤어	전남친이 만나자고 합니다.	1
재회하면 또 그렇겠지	저 잘 잊을 수 있겠죠?	1
혼자인게 좋다	혼자인게 차라리 편해	1
짧은연애인데 미련때문에 연락을 할지말지 ㅠ.ㅠ	찌질한 이별중	1
땅 사면 좋겠다.	땅이나 살까	0
